Año,Edad,Causa de muerte,Total,Hombres,Mujeres
2009,1- 6 días,"Trastornos relacionados con duración corta de la gestación y con bajo peso al nacer, no clasificados en otra parte",350,196,154
2009,1- 6 días,Sepsis bacteriana del recién nacido,223,134,89
2009,1- 6 días,Dificultad respiratoria del recién nacido,212,144,68
2009,1- 6 días,Síndromes de aspiración neonatal,174,92,82
2009,1- 6 días,Neumonía congénita,117,57,60
2009,1- 6 días,Hipoxia intrauterina,89,44,45
2009,1- 6 días,"Otras malformaciones congénitas, no clasificadas en otra parte",86,43,43
2009,1- 6 días,Asfixia del nacimiento,29,12,17
2009,1- 6 días,Trastornos cardiovasculares originados en el período perinatal,27,18,9
2009,1- 6 días,Otras malformaciones congénitas del corazón,26,13,13
2009,1- 6 días,"Neumonía, organismo no especificado",21,17,4
2009,1- 6 días,"Otros problemas respiratorios del recién nacido, originados en el período perinatal",20,11,9
2009,1- 6 días,Coagulación intravascular diseminada en el feto y el recién nacido,20,13,7
2009,1- 6 días,Otras alteraciones de la regulación de la temperatura en el recién nacido,19,8,11
2009,1- 6 días,Otras afecciones originadas en el período perinatal,15,14,1
2009,1- 6 días,"Síntomas, signos y hallazgos anormales clínicos y de laboratorio, no clasificados en otra parte",45,26,19
2009,1- 6 días,Otras causas,240,141,99
2009,7 - 27 días,Sepsis bacteriana del recién nacido,234,135,99
2009,7 - 27 días,"Trastornos relacionados con duración corta de la gestación y con bajo peso al nacer, no clasificados en otra parte",208,124,84
2009,7 - 27 días,Neumonía congénita,170,96,74
2009,7 - 27 días,Dificultad respiratoria del recién nacido,114,64,50
2009,7 - 27 días,Síndromes de aspiración neonatal,66,31,35
2009,7 - 27 días,"Neumonía, organismo no especificado",48,28,20
2009,7 - 27 días,"Otras malformaciones congénitas, no clasificadas en otra parte",42,24,18
2009,7 - 27 días,Enterocolitis necrotizante del feto y del recién nacido,40,20,20
2009,7 - 27 días,Hipoxia intrauterina,38,19,19
2009,7 - 27 días,Otras malformaciones congénitas del corazón,30,20,10
2009,7 - 27 días,Coagulación intravascular diseminada en el feto y el recién nacido,28,14,14
2009,7 - 27 días,"Otros problemas respiratorios del recién nacido, originados en el período perinatal",27,13,14
2009,7 - 27 días,Hemorragia pulmonar originada en el período perinatal,24,12,12
2009,7 - 27 días,Otras afecciones originadas en el período perinatal,19,13,6
2009,7 - 27 días,Diarrea y gastroenteritis de presunto origen infeccioso,18,5,13
2009,7 - 27 días,"Síntomas, signos y hallazgos anormales clínicos y de laboratorio, no clasificados en otra parte",35,16,19
2009,7 - 27 días,Otras causas,262,140,122
2009,28 días a menos de 1 año,"Neumonía, organismo no especificado",1719,971,748
2009,28 días a menos de 1 año,Diarrea y gastroenteritis de presunto origen infeccioso,586,333,253
2009,28 días a menos de 1 año,Otras septicemias,251,145,106
2009,28 días a menos de 1 año,"Desnutrición proteicocalórica, no especificada",216,111,105
2009,28 días a menos de 1 año,Otras malformaciones congénitas del corazón,112,51,61
2009,28 días a menos de 1 año,"Trastornos relacionados con duración corta de la gestación y con bajo peso al nacer, no clasificados en otra parte",83,40,43
2009,28 días a menos de 1 año,Depleción del volumen,58,29,29
2009,28 días a menos de 1 año,"Otras malformaciones congénitas, no clasificadas en otra parte",53,27,26
2009,28 días a menos de 1 año,Sepsis bacteriana del recién nacido,45,27,18
2009,28 días a menos de 1 año,"Neumonía bacteriana, no clasificada en otra parte",43,21,22
2009,28 días a menos de 1 año,Síndrome de Down,43,23,20
2009,28 días a menos de 1 año,Coagulación intravascular diseminada [síndrome de desfibrinación],41,23,18
2009,28 días a menos de 1 año,Ileo paralítico y obstrucción intestinal sin hernia,39,22,17
2009,28 días a menos de 1 año,Hidrocéfalo,38,21,17
2009,28 días a menos de 1 año,Otros trastornos respiratorios,37,23,14
2009,28 días a menos de 1 año,"Síntomas, signos y hallazgos anormales clínicos y de laboratorio, no clasificados en otra parte",328,173,155
2009,28 días a menos de 1 año,Otras causas,1044,579,465
2009,1 año,"Neumonía, organismo no especificado",579,300,279
2009,1 año,Diarrea y gastroenteritis de presunto origen infeccioso,445,223,222
2009,1 año,"Desnutrición proteicocalórica, no especificada",118,48,70
2009,1 año,Otras septicemias,64,34,30
2009,1 año,Depleción del volumen,52,27,25
2009,1 año,Exposición a factores no especificados,28,15,13
2009,1 año,"Parasitosis intestinal, sin otra especificación",17,11,6
2009,1 año,Ahogamiento y sumersión no especificados,16,10,6
2009,1 año,Otras anemias,14,3,11
2009,1 año,"Desnutrición proteicocalórica severa, no especificada",14,10,4
2009,1 año,Hidrocéfalo,14,7,7
2009,1 año,Coagulación intravascular diseminada [síndrome de desfibrinación],13,6,7
2009,1 año,Epilepsia,13,4,9
2009,1 año,Otros trastornos respiratorios,13,8,5
2009,1 año,Otras malformaciones congénitas del corazón,13,7,6
2009,1 año,"Síntomas, signos y hallazgos anormales clínicos y de laboratorio, no clasificados en otra parte",123,64,59
2009,1 año,Otras causas,346,175,171
2009,2 años,"Neumonía, organismo no especificado",166,77,89
2009,2 años,Diarrea y gastroenteritis de presunto origen infeccioso,125,58,67
2009,2 años,"Desnutrición proteicocalórica, no especificada",36,12,24
2009,2 años,Exposición a factores no especificados,28,17,11
2009,2 años,Otras septicemias,21,14,7
2009,2 años,Depleción del volumen,20,10,10
2009,2 años,Ahogamiento y sumersión no especificados,12,8,4
2009,2 años,"Parasitosis intestinal, sin otra especificación",11,4,7
2009,2 años,Epilepsia,10,7,3
2009,2 años,"Exposición a humos, fuegos o llamas no especificados",9,5,4
2009,2 años,Otras anemias,7,3,4
2009,2 años,Hidrocéfalo,7,4,3
2009,2 años,"Desnutrición proteicocalórica severa, no especificada",6,6,0
2009,2 años,Ileo paralítico y obstrucción intestinal sin hernia,6,3,3
2009,2 años,Obstrucción no especificada de la respiración,6,1,5
2009,2 años,"Síntomas, signos y hallazgos anormales clínicos y de laboratorio, no clasificados en otra parte",53,26,27
2009,2 años,Otras causas,166,93,73
2009,3 años,"Neumonía, organismo no especificado",71,31,40
2009,3 años,Diarrea y gastroenteritis de presunto origen infeccioso,35,17,18
2009,3 años,Exposición a factores no especificados,28,19,9
2009,3 años,"Desnutrición proteicocalórica, no especificada",12,7,5
2009,3 años,Depleción del volumen,12,5,7
2009,3 años,Otras septicemias,9,6,3
2009,3 años,Otros trastornos del encéfalo,8,4,4
2009,3 años,Otras malformaciones congénitas del corazón,7,3,4
2009,3 años,Coagulación intravascular diseminada [síndrome de desfibrinación],6,4,2
2009,3 años,Microcefalia,5,1,4
2009,3 años,Ahogamiento y sumersión no especificados,5,0,5
2009,3 años,Leucemia linfoide,4,3,1
2009,3 años,Epilepsia,4,3,1
2009,3 años,"Ahorcamiento, estrangulamiento y sofocación, de intención no determinada",4,1,3
2009,3 años,Tumor maligno del ojo y sus anexos,3,2,1
2009,3 años,"Síntomas, signos y hallazgos anormales clínicos y de laboratorio, no clasificados en otra parte",22,13,9
2009,3 años,Otras causas,122,65,57
2009,4 años,"Neumonía, organismo no especificado",40,20,20
2009,4 años,Diarrea y gastroenteritis de presunto origen infeccioso,36,19,17
2009,4 años,Exposición a factores no especificados,19,11,8
2009,4 años,"Desnutrición proteicocalórica, no especificada",12,4,8
2009,4 años,Otras septicemias,7,2,5
2009,4 años,Meningitis debida a otras causas y a las no especificadas,6,6,0
2009,4 años,Otros trastornos respiratorios,6,1,5
2009,4 años,Otros trastornos del encéfalo,5,1,4
2009,4 años,Epilepsia,4,1,3
2009,4 años,Leucemia linfoide,3,2,1
2009,4 años,"Desnutrición proteicocalórica severa, no especificada",3,1,2
2009,4 años,Depleción del volumen,3,2,1
2009,4 años,Parálisis cerebral,3,2,1
2009,4 años,Hidrocéfalo,3,2,1
2009,4 años,Peritonitis,3,1,2
2009,4 años,"Síntomas, signos y hallazgos anormales clínicos y de laboratorio, no clasificados en otra parte",17,10,7
2009,4 años,Otras causas,61,29,32
2009,5 - 9 años,"Neumonía, organismo no especificado",122,63,59
2009,5 - 9 años,Exposición a factores no especificados,97,65,32
2009,5 - 9 años,Diarrea y gastroenteritis de presunto origen infeccioso,96,36,60
2009,5 - 9 años,"Desnutrición proteicocalórica, no especificada",36,20,16
2009,5 - 9 años,Otras septicemias,30,19,11
2009,5 - 9 años,Leucemia linfoide,20,9,11
2009,5 - 9 años,Otras anemias,15,7,8
2009,5 - 9 años,Depleción del volumen,14,3,11
2009,5 - 9 años,"Agresión con disparo de otras armas de fuego, y las no especificadas",14,8,6
2009,5 - 9 años,Leucemia de células de tipo no especificado,13,6,7
2009,5 - 9 años,Epilepsia,12,9,3
2009,5 - 9 años,Coagulación intravascular diseminada [síndrome de desfibrinación],11,5,6
2009,5 - 9 años,Otros trastornos del encéfalo,11,3,8
2009,5 - 9 años,Ileo paralítico y obstrucción intestinal sin hernia,11,4,7
2009,5 - 9 años,Fiebre del dengue hemorrágico,9,6,3
2009,5 - 9 años,"Síntomas, signos y hallazgos anormales clínicos y de laboratorio, no clasificados en otra parte",71,41,30
2009,5 - 9 años,Otras causas,355,192,163
2009,10 - 14 años,Exposición a factores no especificados,103,80,23
2009,10 - 14 años,"Agresión con disparo de otras armas de fuego, y las no especificadas",71,47,24
2009,10 - 14 años,"Neumonía, organismo no especificado",67,36,31
2009,10 - 14 años,Diarrea y gastroenteritis de presunto origen infeccioso,46,23,23
2009,10 - 14 años,Ahogamiento y sumersión no especificados,20,15,5
2009,10 - 14 años,"Desnutrición proteicocalórica, no especificada",19,9,10
2009,10 - 14 años,Leucemia de células de tipo no especificado,18,8,10
2009,10 - 14 años,Insuficiencia renal crónica,17,9,8
2009,10 - 14 años,Otras septicemias,16,5,11
2009,10 - 14 años,Leucemia linfoide,15,9,6
2009,10 - 14 años,Otros trastornos del encéfalo,14,5,9
2009,10 - 14 años,Epilepsia,12,9,3
2009,10 - 14 años,Secuelas de otros efectos y los no especificados de causas externas,12,8,4
2009,10 - 14 años,Otras anemias,11,7,4
2009,10 - 14 años,Tumor maligno del hígado y de las vías biliares intrahepáticas,10,9,1
2009,10 - 14 años,"Síntomas, signos y hallazgos anormales clínicos y de laboratorio, no clasificados en otra parte",71,34,37
2009,10 - 14 años,Otras causas,383,204,179
2009,15 - 19 años,"Agresión con disparo de otras armas de fuego, y las no especificadas",737,660,77
2009,15 - 19 años,Exposición a factores no especificados,290,247,43
2009,15 - 19 años,"Neumonía, organismo no especificado",83,50,33
2009,15 - 19 años,"Disparo de otras armas de fuego, y las no especificadas, de intención no determinada",67,57,10
2009,15 - 19 años,Agresión con objeto cortante,49,40,9
2009,15 - 19 años,Ahogamiento y sumersión no especificados,33,27,6
2009,15 - 19 años,Otras septicemias,32,14,18
2009,15 - 19 años,Leucemia de células de tipo no especificado,31,15,16
2009,15 - 19 años,Diarrea y gastroenteritis de presunto origen infeccioso,29,19,10
2009,15 - 19 años,Epilepsia,29,18,11
2009,15 - 19 años,"Envenenamiento autoinfligido intencionalmente por, y exposición a otros productos químicos y sustancias nocivas, y los no especificados",29,11,18
2009,15 - 19 años,"Lesión autoinfligida intencionalmente por ahorcamiento, estrangulamiento o sofocación",28,22,6
2009,15 - 19 años,Agresión por medios no especificados,25,20,5
2009,15 - 19 años,"Desnutrición proteicocalórica, no especificada",24,6,18
2009,15 - 19 años,Insuficiencia renal crónica,24,10,14
2009,15 - 19 años,"Síntomas, signos y hallazgos anormales clínicos y de laboratorio, no clasificados en otra parte",85,40,45
2009,15 - 19 años,Otras causas,788,429,359
2009,20 - 24 años,"Agresión con disparo de otras armas de fuego, y las no especificadas",972,903,69
2009,20 - 24 años,Exposición a factores no especificados,437,394,43
2009,20 - 24 años,"Neumonía, organismo no especificado",91,45,46
2009,20 - 24 años,Agresión con objeto cortante,59,48,11
2009,20 - 24 años,"Disparo de otras armas de fuego, y las no especificadas, de intención no determinada",59,55,4
2009,20 - 24 años,Agresión por medios no especificados,56,51,5
2009,20 - 24 años,Trastornos mentales y del comportamiento debidos al uso de alcohol,44,39,5
2009,20 - 24 años,"Disparo de otras armas de fuego, y las no especificadas",41,38,3
2009,20 - 24 años,"Lesión autoinfligida intencionalmente por ahorcamiento, estrangulamiento o sofocación",37,32,5
2009,20 - 24 años,Diarrea y gastroenteritis de presunto origen infeccioso,33,18,15
2009,20 - 24 años,Secuelas de otros efectos y los no especificados de causas externas,32,26,6
2009,20 - 24 años,"Enfermedad por virus de la inmunodeficiencia humana [VIH], sin otra especificación",31,20,11
2009,20 - 24 años,Infarto agudo del miocardio,30,15,15
2009,20 - 24 años,Ahogamiento y sumersión no especificados,30,26,4
2009,20 - 24 años,"Tuberculosis respiratoria, no confirmada bacteriológica o histológicamente",25,13,12
2009,20 - 24 años,"Síntomas, signos y hallazgos anormales clínicos y de laboratorio, no clasificados en otra parte",102,64,38
2009,20 - 24 años,Otras causas,912,503,409
2009,25 - 29 años,"Agresión con disparo de otras armas de fuego, y las no especificadas",930,853,77
2009,25 - 29 años,Exposición a factores no especificados,388,348,40
2009,25 - 29 años,"Neumonía, organismo no especificado",124,70,54
2009,25 - 29 años,Trastornos mentales y del comportamiento debidos al uso de alcohol,107,100,7
2009,25 - 29 años,"Disparo de otras armas de fuego, y las no especificadas, de intención no determinada",75,69,6
2009,25 - 29 años,"Enfermedad por virus de la inmunodeficiencia humana [VIH], sin otra especificación",73,50,23
2009,25 - 29 años,Fibrosis y cirrosis del hígado,61,52,9
2009,25 - 29 años,Diarrea y gastroenteritis de presunto origen infeccioso,57,39,18
2009,25 - 29 años,Agresión con objeto cortante,57,49,8
2009,25 - 29 años,Agresión por medios no especificados,55,49,6
2009,25 - 29 años,Infarto agudo del miocardio,43,21,22
2009,25 - 29 años,"Desnutrición proteicocalórica, no especificada",38,18,20
2009,25 - 29 años,Ahogamiento y sumersión no especificados,38,34,4
2009,25 - 29 años,Enfermedad alcohólica del hígado,36,30,6
2009,25 - 29 años,Otras septicemias,32,17,15
2009,25 - 29 años,"Síntomas, signos y hallazgos anormales clínicos y de laboratorio, no clasificados en otra parte",117,65,52
2009,25 - 29 años,Otras causas,1062,612,450
2009,30 - 34 años,"Agresión con disparo de otras armas de fuego, y las no especificadas",696,636,60
2009,30 - 34 años,Exposición a factores no especificados,323,292,31
2009,30 - 34 años,"Neumonía, organismo no especificado",106,55,51
2009,30 - 34 años,Trastornos mentales y del comportamiento debidos al uso de alcohol,104,101,3
2009,30 - 34 años,Fibrosis y cirrosis del hígado,85,71,14
2009,30 - 34 años,"Enfermedad por virus de la inmunodeficiencia humana [VIH], sin otra especificación",81,61,20
2009,30 - 34 años,Infarto agudo del miocardio,60,41,19
2009,30 - 34 años,Diarrea y gastroenteritis de presunto origen infeccioso,51,28,23
2009,30 - 34 años,Enfermedad alcohólica del hígado,51,47,4
2009,30 - 34 años,"Disparo de otras armas de fuego, y las no especificadas, de intención no determinada",51,46,5
2009,30 - 34 años,Agresión con objeto cortante,50,48,2
2009,30 - 34 años,Agresión por medios no especificados,46,41,5
2009,30 - 34 años,Secuelas de otros efectos y los no especificados de causas externas,40,35,5
2009,30 - 34 años,"Diabetes mellitus, no especificada",39,21,18
2009,30 - 34 años,Otras septicemias,33,17,16
2009,30 - 34 años,"Síntomas, signos y hallazgos anormales clínicos y de laboratorio, no clasificados en otra parte",126,72,54
2009,30 - 34 años,Otras causas,988,559,429
2009,35 - 39 años,"Agresión con disparo de otras armas de fuego, y las no especificadas",463,424,39
2009,35 - 39 años,Exposición a factores no especificados,273,251,22
2009,35 - 39 años,Trastornos mentales y del comportamiento debidos al uso de alcohol,111,101,10
2009,35 - 39 años,Fibrosis y cirrosis del hígado,110,98,12
2009,35 - 39 años,"Neumonía, organismo no especificado",106,64,42
2009,35 - 39 años,Infarto agudo del miocardio,79,52,27
2009,35 - 39 años,"Diabetes mellitus, no especificada",63,36,27
2009,35 - 39 años,Enfermedad alcohólica del hígado,62,51,11
2009,35 - 39 años,Diarrea y gastroenteritis de presunto origen infeccioso,57,33,24
2009,35 - 39 años,"Enfermedad por virus de la inmunodeficiencia humana [VIH], sin otra especificación",55,43,12
2009,35 - 39 años,Tumor maligno del estómago,43,19,24
2009,35 - 39 años,Agresión con objeto cortante,43,36,7
2009,35 - 39 años,"Desnutrición proteicocalórica, no especificada",32,20,12
2009,35 - 39 años,"Disparo de otras armas de fuego, y las no especificadas, de intención no determinada",31,26,5
2009,35 - 39 años,"Accidente vascular encefálico agudo, no especificado como hemorrágico o isquémico",29,10,19
2009,35 - 39 años,"Síntomas, signos y hallazgos anormales clínicos y de laboratorio, no clasificados en otra parte",116,64,52
2009,35 - 39 años,Otras causas,1009,592,417
2009,40 - 44 años,"Agresión con disparo de otras armas de fuego, y las no especificadas",369,337,32
2009,40 - 44 años,Exposición a factores no especificados,247,231,16
2009,40 - 44 años,Trastornos mentales y del comportamiento debidos al uso de alcohol,139,128,11
2009,40 - 44 años,Fibrosis y cirrosis del hígado,139,107,32
2009,40 - 44 años,"Neumonía, organismo no especificado",109,70,39
2009,40 - 44 años,"Diabetes mellitus, no especificada",86,41,45
2009,40 - 44 años,Enfermedad alcohólica del hígado,85,68,17
2009,40 - 44 años,Infarto agudo del miocardio,76,42,34
2009,40 - 44 años,Tumor maligno del estómago,60,22,38
2009,40 - 44 años,"Enfermedad por virus de la inmunodeficiencia humana [VIH], sin otra especificación",49,39,10
2009,40 - 44 años,Diarrea y gastroenteritis de presunto origen infeccioso,46,33,13
2009,40 - 44 años,"Desnutrición proteicocalórica, no especificada",35,16,19
2009,40 - 44 años,Agresión con objeto cortante,35,30,5
2009,40 - 44 años,Diabetes mellitus no insulinodependiente,34,16,18
2009,40 - 44 años,Pancreatitis aguda,30,19,11
2009,40 - 44 años,"Síntomas, signos y hallazgos anormales clínicos y de laboratorio, no clasificados en otra parte",118,75,43
2009,40 - 44 años,Otras causas,1044,550,494
2009,45 - 49 años,"Agresión con disparo de otras armas de fuego, y las no especificadas",276,241,35
2009,45 - 49 años,Fibrosis y cirrosis del hígado,188,136,52
2009,45 - 49 años,Exposición a factores no especificados,184,159,25
2009,45 - 49 años,Trastornos mentales y del comportamiento debidos al uso de alcohol,156,141,15
2009,45 - 49 años,"Diabetes mellitus, no especificada",154,80,74
2009,45 - 49 años,"Neumonía, organismo no especificado",137,76,61
2009,45 - 49 años,Infarto agudo del miocardio,125,76,49
2009,45 - 49 años,Enfermedad alcohólica del hígado,86,78,8
2009,45 - 49 años,Diarrea y gastroenteritis de presunto origen infeccioso,56,28,28
2009,45 - 49 años,Tumor maligno del hígado y de las vías biliares intrahepáticas,56,26,30
2009,45 - 49 años,Tumor maligno del estómago,53,20,33
2009,45 - 49 años,Tumor maligno del cuello del útero,51,0,51
2009,45 - 49 años,Insuficiencia renal crónica,51,20,31
2009,45 - 49 años,Diabetes mellitus no insulinodependiente,50,21,29
2009,45 - 49 años,"Desnutrición proteicocalórica, no especificada",44,23,21
2009,45 - 49 años,"Síntomas, signos y hallazgos anormales clínicos y de laboratorio, no clasificados en otra parte",141,77,64
2009,45 - 49 años,Otras causas,1127,606,521
2009,50 - 54 años,"Diabetes mellitus, no especificada",283,123,160
2009,50 - 54 años,Exposición a factores no especificados,216,186,30
2009,50 - 54 años,Fibrosis y cirrosis del hígado,187,129,58
2009,50 - 54 años,"Agresión con disparo de otras armas de fuego, y las no especificadas",174,150,24
2009,50 - 54 años,Infarto agudo del miocardio,167,102,65
2009,50 - 54 años,Trastornos mentales y del comportamiento debidos al uso de alcohol,140,123,17
2009,50 - 54 años,"Neumonía, organismo no especificado",128,68,60
2009,50 - 54 años,Tumor maligno del estómago,98,38,60
2009,50 - 54 años,Tumor maligno del hígado y de las vías biliares intrahepáticas,83,35,48
2009,50 - 54 años,Enfermedad alcohólica del hígado,78,64,14
2009,50 - 54 años,Diabetes mellitus no insulinodependiente,77,34,43
2009,50 - 54 años,Diarrea y gastroenteritis de presunto origen infeccioso,64,31,33
2009,50 - 54 años,"Accidente vascular encefálico agudo, no especificado como hemorrágico o isquémico",63,22,41
2009,50 - 54 años,Tumor maligno del cuello del útero,55,0,55
2009,50 - 54 años,"Desnutrición proteicocalórica, no especificada",54,27,27
2009,50 - 54 años,"Síntomas, signos y hallazgos anormales clínicos y de laboratorio, no clasificados en otra parte",142,79,63
2009,50 - 54 años,Otras causas,1285,689,596
2009,55 - 59 años,"Diabetes mellitus, no especificada",343,151,192
2009,55 - 59 años,"Neumonía, organismo no especificado",218,117,101
2009,55 - 59 años,Infarto agudo del miocardio,204,127,77
2009,55 - 59 años,Fibrosis y cirrosis del hígado,177,111,66
2009,55 - 59 años,Exposición a factores no especificados,157,126,31
2009,55 - 59 años,Diabetes mellitus no insulinodependiente,123,58,65
2009,55 - 59 años,"Agresión con disparo de otras armas de fuego, y las no especificadas",121,104,17
2009,55 - 59 años,Tumor maligno del hígado y de las vías biliares intrahepáticas,117,66,51
2009,55 - 59 años,Trastornos mentales y del comportamiento debidos al uso de alcohol,113,97,16
2009,55 - 59 años,Tumor maligno del estómago,112,55,57
2009,55 - 59 años,Diarrea y gastroenteritis de presunto origen infeccioso,77,42,35
2009,55 - 59 años,Insuficiencia renal crónica,77,40,37
2009,55 - 59 años,Enfermedad alcohólica del hígado,73,59,14
2009,55 - 59 años,"Accidente vascular encefálico agudo, no especificado como hemorrágico o isquémico",69,26,43
2009,55 - 59 años,Insuficiencia cardíaca,53,25,28
2009,55 - 59 años,"Síntomas, signos y hallazgos anormales clínicos y de laboratorio, no clasificados en otra parte",171,88,83
2009,55 - 59 años,Otras causas,1464,729,735
2009,60 - 64 años,"Diabetes mellitus, no especificada",372,163,209
2009,60 - 64 años,Infarto agudo del miocardio,235,146,89
2009,60 - 64 años,"Neumonía, organismo no especificado",234,123,111
2009,60 - 64 años,Fibrosis y cirrosis del hígado,184,104,80
2009,60 - 64 años,Exposición a factores no especificados,159,124,35
2009,60 - 64 años,Tumor maligno del estómago,134,55,79
2009,60 - 64 años,Diabetes mellitus no insulinodependiente,125,48,77
2009,60 - 64 años,Tumor maligno del hígado y de las vías biliares intrahepáticas,119,56,63
2009,60 - 64 años,"Accidente vascular encefálico agudo, no especificado como hemorrágico o isquémico",103,40,63
2009,60 - 64 años,Insuficiencia cardíaca,94,40,54
2009,60 - 64 años,Insuficiencia renal crónica,90,53,37
2009,60 - 64 años,Diarrea y gastroenteritis de presunto origen infeccioso,89,45,44
2009,60 - 64 años,Trastornos mentales y del comportamiento debidos al uso de alcohol,85,83,2
2009,60 - 64 años,"Desnutrición proteicocalórica, no especificada",83,41,42
2009,60 - 64 años,"Agresión con disparo de otras armas de fuego, y las no especificadas",72,57,15
2009,60 - 64 años,"Síntomas, signos y hallazgos anormales clínicos y de laboratorio, no clasificados en otra parte",204,110,94
2009,60 - 64 años,Otras causas,1516,781,735
2009,65 - 69 años,"Diabetes mellitus, no especificada",378,149,229
2009,65 - 69 años,"Neumonía, organismo no especificado",288,141,147
2009,65 - 69 años,Infarto agudo del miocardio,282,159,123
2009,65 - 69 años,Fibrosis y cirrosis del hígado,184,99,85
2009,65 - 69 años,Tumor maligno del estómago,154,81,73
2009,65 - 69 años,Tumor maligno del hígado y de las vías biliares intrahepáticas,154,69,85
2009,65 - 69 años,Exposición a factores no especificados,134,110,24
2009,65 - 69 años,Diabetes mellitus no insulinodependiente,115,50,65
2009,65 - 69 años,"Accidente vascular encefálico agudo, no especificado como hemorrágico o isquémico",103,50,53
2009,65 - 69 años,Insuficiencia cardíaca,94,53,41
2009,65 - 69 años,Diarrea y gastroenteritis de presunto origen infeccioso,91,50,41
2009,65 - 69 años,"Desnutrición proteicocalórica, no especificada",87,42,45
2009,65 - 69 años,Insuficiencia renal crónica,76,39,37
2009,65 - 69 años,Trastornos mentales y del comportamiento debidos al uso de alcohol,64,57,7
2009,65 - 69 años,Hipertensión esencial (primaria),54,21,33
2009,65 - 69 años,"Síntomas, signos y hallazgos anormales clínicos y de laboratorio, no clasificados en otra parte",239,117,122
2009,65 - 69 años,Otras causas,1532,825,707
2009,70 - 74 años,"Diabetes mellitus, no especificada",405,156,249
2009,70 - 74 años,"Neumonía, organismo no especificado",401,227,174
2009,70 - 74 años,Infarto agudo del miocardio,348,201,147
2009,70 - 74 años,"Accidente vascular encefálico agudo, no especificado como hemorrágico o isquémico",184,87,97
2009,70 - 74 años,Tumor maligno del estómago,178,89,89
2009,70 - 74 años,Insuficiencia cardíaca,160,82,78
2009,70 - 74 años,"Desnutrición proteicocalórica, no especificada",151,77,74
2009,70 - 74 años,Fibrosis y cirrosis del hígado,151,81,70
2009,70 - 74 años,Diabetes mellitus no insulinodependiente,144,56,88
2009,70 - 74 años,Tumor maligno del hígado y de las vías biliares intrahepáticas,137,69,68
2009,70 - 74 años,Exposición a factores no especificados,123,101,22
2009,70 - 74 años,Diarrea y gastroenteritis de presunto origen infeccioso,102,68,34
2009,70 - 74 años,Insuficiencia renal crónica,87,44,43
2009,70 - 74 años,Otras enfermedades cerebrovasculares,74,34,40
2009,70 - 74 años,"Síntomas, signos y hallazgos anormales clínicos y de laboratorio, no clasificados en otra parte",383,185,198
2009,70 - 74 años,Otras causas,1714,929,785
2009,75 - 79 años,"Neumonía, organismo no especificado",512,281,231
2009,75 - 79 años,Infarto agudo del miocardio,414,205,209
2009,75 - 79 años,"Diabetes mellitus, no especificada",329,137,192
2009,75 - 79 años,Insuficiencia cardíaca,277,149,128
2009,75 - 79 años,"Desnutrición proteicocalórica, no especificada",227,106,121
2009,75 - 79 años,"Accidente vascular encefálico agudo, no especificado como hemorrágico o isquémico",217,113,104
2009,75 - 79 años,Tumor maligno del estómago,184,86,98
2009,75 - 79 años,Exposición a factores no especificados,147,106,41
2009,75 - 79 años,Tumor maligno del hígado y de las vías biliares intrahepáticas,129,60,69
2009,75 - 79 años,Diabetes mellitus no insulinodependiente,127,58,69
2009,75 - 79 años,Fibrosis y cirrosis del hígado,121,82,39
2009,75 - 79 años,Otras enfermedades cerebrovasculares,113,56,57
2009,75 - 79 años,Otras enfermedades pulmonares obstructivas crónicas,112,62,50
2009,75 - 79 años,Diarrea y gastroenteritis de presunto origen infeccioso,106,54,52
2009,75 - 79 años,Insuficiencia renal crónica,93,57,36
2009,75 - 79 años,"Síntomas, signos y hallazgos anormales clínicos y de laboratorio, no clasificados en otra parte",500,241,259
2009,75 - 79 años,Otras causas,1887,1007,880
2009,80 - 84 años,"Neumonía, organismo no especificado",656,345,311
2009,80 - 84 años,Infarto agudo del miocardio,510,261,249
2009,80 - 84 años,Insuficiencia cardíaca,321,143,178
2009,80 - 84 años,"Accidente vascular encefálico agudo, no especificado como hemorrágico o isquémico",275,133,142
2009,80 - 84 años,"Desnutrición proteicocalórica, no especificada",264,117,147
2009,80 - 84 años,"Diabetes mellitus, no especificada",253,94,159
2009,80 - 84 años,Tumor maligno del estómago,156,65,91
2009,80 - 84 años,Exposición a factores no especificados,127,81,46
2009,80 - 84 años,Otras enfermedades pulmonares obstructivas crónicas,125,59,66
2009,80 - 84 años,Hipertensión esencial (primaria),108,40,68
2009,80 - 84 años,Diarrea y gastroenteritis de presunto origen infeccioso,107,63,44
2009,80 - 84 años,Tumor maligno del hígado y de las vías biliares intrahepáticas,106,54,52
2009,80 - 84 años,Otras enfermedades cerebrovasculares,102,52,50
2009,80 - 84 años,Insuficiencia renal no especificada,88,42,46
2009,80 - 84 años,"Síntomas, signos y hallazgos anormales clínicos y de laboratorio, no clasificados en otra parte",703,328,375
2009,80 - 84 años,Otras causas,1817,906,911
2009,85 y más,"Neumonía, organismo no especificado",956,478,478
2009,85 y más,Infarto agudo del miocardio,790,368,422
2009,85 y más,Insuficiencia cardíaca,518,249,269
2009,85 y más,"Desnutrición proteicocalórica, no especificada",430,176,254
2009,85 y más,"Accidente vascular encefálico agudo, no especificado como hemorrágico o isquémico",349,161,188
2009,85 y más,"Diabetes mellitus, no especificada",232,91,141
2009,85 y más,Otras enfermedades pulmonares obstructivas crónicas,176,87,89
2009,85 y más,Tumor maligno del estómago,153,72,81
2009,85 y más,Diarrea y gastroenteritis de presunto origen infeccioso,140,69,71
2009,85 y más,Tumor maligno de la próstata,140,140,0
2009,85 y más,Otras enfermedades cerebrovasculares,139,48,91
2009,85 y más,Exposición a factores no especificados,136,81,55
2009,85 y más,Hipertensión esencial (primaria),116,38,78
2009,85 y más,Tumor maligno del hígado y de las vías biliares intrahepáticas,95,49,46
2009,85 y más,Insuficiencia renal crónica,86,46,40
2009,85 y más,"Síntomas, signos y hallazgos anormales clínicos y de laboratorio, no clasificados en otra parte",1144,497,647
2009,85 y más,Otras causas,1808,835,973
2010,1- 6 días,"Trastornos relacionados con duración corta de la gestación y con bajo peso al nacer, no clasificados en otra parte",521,324,197
2010,1- 6 días,Hipoxia intrauterina,136,78,58
2010,1- 6 días,Síndromes de aspiración neonatal,119,59,60
2010,1- 6 días,Sepsis bacteriana del recién nacido,106,64,42
2010,1- 6 días,Neumonía congénita,78,47,31
2010,1- 6 días,"Otras malformaciones congénitas, no clasificadas en otra parte",65,35,30
2010,1- 6 días,Dificultad respiratoria del recién nacido,56,33,23
2010,1- 6 días,Trastornos cardiovasculares originados en el período perinatal,31,18,13
2010,1- 6 días,Otras malformaciones congénitas del corazón,28,17,11
2010,1- 6 días,Otras afecciones originadas en el período perinatal,21,13,8
2010,1- 6 días,"Neumonía, organismo no especificado",19,9,10
2010,1- 6 días,Anencefalia y malformaciones congénitas similares,19,6,13
2010,1- 6 días,Otras alteraciones de la regulación de la temperatura en el recién nacido,13,9,4
2010,1- 6 días,Hemorragia pulmonar originada en el período perinatal,11,7,4
2010,1- 6 días,Otras hemorragias neonatales,10,4,6
2010,1- 6 días,"Síntomas, signos y hallazgos anormales clínicos y de laboratorio, no clasificados en otra parte",43,24,19
2010,1- 6 días,Otras causas,223,128,95
2010,7 - 27 días,"Trastornos relacionados con duración corta de la gestación y con bajo peso al nacer, no clasificados en otra parte",400,224,176
2010,7 - 27 días,Sepsis bacteriana del recién nacido,209,113,96
2010,7 - 27 días,Neumonía congénita,159,98,61
2010,7 - 27 días,Hipoxia intrauterina,83,44,39
2010,7 - 27 días,Síndromes de aspiración neonatal,64,43,21
2010,7 - 27 días,Otras malformaciones congénitas del corazón,46,26,20
2010,7 - 27 días,"Neumonía, organismo no especificado",44,19,25
2010,7 - 27 días,Dificultad respiratoria del recién nacido,37,22,15
2010,7 - 27 días,"Otras malformaciones congénitas, no clasificadas en otra parte",35,21,14
2010,7 - 27 días,Enterocolitis necrotizante del feto y del recién nacido,32,21,11
2010,7 - 27 días,Coagulación intravascular diseminada en el feto y el recién nacido,29,18,11
2010,7 - 27 días,Otras afecciones originadas en el período perinatal,25,11,14
2010,7 - 27 días,Hemorragia pulmonar originada en el período perinatal,21,10,11
2010,7 - 27 días,Espina bífida,16,4,12
2010,7 - 27 días,Trastornos cardiovasculares originados en el período perinatal,15,10,5
2010,7 - 27 días,"Síntomas, signos y hallazgos anormales clínicos y de laboratorio, no clasificados en otra parte",55,34,21
2010,7 - 27 días,Otras causas,292,169,123
2010,28 días a menos de 1 año,"Neumonía, organismo no especificado",1524,848,676
2010,28 días a menos de 1 año,Diarrea y gastroenteritis de presunto origen infeccioso,461,271,190
2010,28 días a menos de 1 año,Otras septicemias,242,128,114
2010,28 días a menos de 1 año,"Desnutrición proteicocalórica, no especificada",121,62,59
2010,28 días a menos de 1 año,Otras malformaciones congénitas del corazón,120,63,57
2010,28 días a menos de 1 año,"Trastornos relacionados con duración corta de la gestación y con bajo peso al nacer, no clasificados en otra parte",108,56,52
2010,28 días a menos de 1 año,Obstrucción no especificada de la respiración,79,42,37
2010,28 días a menos de 1 año,"Desnutrición proteicocalórica severa, no especificada",51,26,25
2010,28 días a menos de 1 año,Sepsis bacteriana del recién nacido,51,38,13
2010,28 días a menos de 1 año,Otros trastornos respiratorios,48,21,27
2010,28 días a menos de 1 año,"Otras malformaciones congénitas, no clasificadas en otra parte",46,23,23
2010,28 días a menos de 1 año,Síndrome de Down,36,11,25
2010,28 días a menos de 1 año,"Neumonía bacteriana, no clasificada en otra parte",34,18,16
2010,28 días a menos de 1 año,Ileo paralítico y obstrucción intestinal sin hernia,33,17,16
2010,28 días a menos de 1 año,"Otros trastornos de los líquidos, de los electrólitos y del equilibrio ácido-básico",32,22,10
2010,28 días a menos de 1 año,"Síntomas, signos y hallazgos anormales clínicos y de laboratorio, no clasificados en otra parte",339,182,157
2010,28 días a menos de 1 año,Otras causas,1001,561,440
2010,1 año,"Neumonía, organismo no especificado",530,278,252
2010,1 año,Diarrea y gastroenteritis de presunto origen infeccioso,438,250,188
2010,1 año,"Desnutrición proteicocalórica, no especificada",70,35,35
2010,1 año,Otras septicemias,64,45,19
2010,1 año,"Desnutrición proteicocalórica severa, no especificada",30,16,14
2010,1 año,Depleción del volumen,30,13,17
2010,1 año,Desnutrición proteicocalórica de grado moderado y leve,25,10,15
2010,1 año,"Otros trastornos de los líquidos, de los electrólitos y del equilibrio ácido-básico",24,12,12
2010,1 año,Otras malformaciones congénitas del corazón,19,11,8
2010,1 año,Exposición a factores no especificados,17,9,8
2010,1 año,"Neumonía bacteriana, no clasificada en otra parte",16,7,9
2010,1 año,Obstrucción no especificada de la respiración,16,6,10
2010,1 año,Hidrocéfalo,14,10,4
2010,1 año,"Parasitosis intestinal, sin otra especificación",12,7,5
2010,1 año,Bronquitis aguda,12,7,5
2010,1 año,"Síntomas, signos y hallazgos anormales clínicos y de laboratorio, no clasificados en otra parte",101,48,53
2010,1 año,Otras causas,333,184,149
2010,2 años,"Neumonía, organismo no especificado",147,77,70
2010,2 años,Diarrea y gastroenteritis de presunto origen infeccioso,134,73,61
2010,2 años,"Desnutrición proteicocalórica, no especificada",43,26,17
2010,2 años,"Desnutrición proteicocalórica severa, no especificada",19,8,11
2010,2 años,Exposición a factores no especificados,18,9,9
2010,2 años,Otras septicemias,13,11,2
2010,2 años,Obstrucción no especificada de la respiración,13,7,6
2010,2 años,Depleción del volumen,12,7,5
2010,2 años,Secuelas de otros efectos y los no especificados de causas externas,9,8,1
2010,2 años,"Ahogamiento y sumersión, de intención no determinada",7,5,2
2010,2 años,Desnutrición proteicocalórica de grado moderado y leve,6,2,4
2010,2 años,"Neumonía bacteriana, no clasificada en otra parte",6,4,2
2010,2 años,Insuficiencia renal aguda,6,3,3
2010,2 años,"Obstrucción de la respiración debida a hundimiento, caída de tierra u otras sustancias",6,4,2
2010,2 años,"Parasitosis intestinal, sin otra especificación",5,1,4
2010,2 años,"Síntomas, signos y hallazgos anormales clínicos y de laboratorio, no clasificados en otra parte",38,20,18
2010,2 años,Otras causas,181,103,78
2010,3 años,"Neumonía, organismo no especificado",68,29,39
2010,3 años,Diarrea y gastroenteritis de presunto origen infeccioso,63,33,30
2010,3 años,Exposición a factores no especificados,11,4,7
2010,3 años,"Desnutrición proteicocalórica, no especificada",8,4,4
2010,3 años,Otras septicemias,7,5,2
2010,3 años,Parálisis cerebral,7,2,5
2010,3 años,"Desnutrición proteicocalórica severa, no especificada",6,1,5
2010,3 años,"Otros trastornos de los líquidos, de los electrólitos y del equilibrio ácido-básico",6,5,1
2010,3 años,Tumor maligno del ojo y sus anexos,5,2,3
2010,3 años,Leucemia de células de tipo no especificado,5,4,1
2010,3 años,Otros trastornos del encéfalo,5,2,3
2010,3 años,"Ahogamiento y sumersión, de intención no determinada",5,2,3
2010,3 años,"Exposición al humo, fuego y llamas, de intención no determinada",5,4,1
2010,3 años,Otras anemias,4,3,1
2010,3 años,"Insuficiencia hepática, no clasificada en otra parte",4,3,1
2010,3 años,"Síntomas, signos y hallazgos anormales clínicos y de laboratorio, no clasificados en otra parte",24,13,11
2010,3 años,Otras causas,99,53,46
2010,4 años,Diarrea y gastroenteritis de presunto origen infeccioso,35,13,22
2010,4 años,"Neumonía, organismo no especificado",30,12,18
2010,4 años,Otras septicemias,10,5,5
2010,4 años,Otros trastornos del encéfalo,7,1,6
2010,4 años,Exposición a factores no especificados,7,4,3
2010,4 años,"Desnutrición proteicocalórica, no especificada",6,3,3
2010,4 años,"Obstrucción de la respiración debida a hundimiento, caída de tierra u otras sustancias",6,1,5
2010,4 años,Leucemia linfoide,5,3,2
2010,4 años,Ahogamiento y sumersión no especificados,5,2,3
2010,4 años,"Desnutrición proteicocalórica severa, no especificada",4,2,2
2010,4 años,"Otras malformaciones congénitas, no clasificadas en otra parte",4,3,1
2010,4 años,Fiebre del dengue [dengue clásico],3,1,2
2010,4 años,Fiebre del dengue hemorrágico,3,1,2
2010,4 años,"Parasitosis intestinal, sin otra especificación",3,1,2
2010,4 años,"Síntomas, signos y hallazgos anormales clínicos y de laboratorio, no clasificados en otra parte",18,10,8
2010,4 años,Otras causas,78,43,35
2010,5 - 9 años,"Neumonía, organismo no especificado",114,61,53
2010,5 - 9 años,Diarrea y gastroenteritis de presunto origen infeccioso,79,40,39
2010,5 - 9 años,Exposición a factores no especificados,60,41,19
2010,5 - 9 años,Secuelas de otros efectos y los no especificados de causas externas,31,14,17
2010,5 - 9 años,"Obstrucción de la respiración debida a hundimiento, caída de tierra u otras sustancias",23,14,9
2010,5 - 9 años,"Desnutrición proteicocalórica, no especificada",22,9,13
2010,5 - 9 años,Otras septicemias,21,12,9
2010,5 - 9 años,Otros trastornos del encéfalo,19,12,7
2010,5 - 9 años,Parálisis cerebral,16,9,7
2010,5 - 9 años,Epilepsia,14,9,5
2010,5 - 9 años,Leucemia de células de tipo no especificado,13,7,6
2010,5 - 9 años,Leucemia linfoide,12,8,4
2010,5 - 9 años,Fiebre del dengue hemorrágico,11,2,9
2010,5 - 9 años,Tumor maligno del encéfalo,10,7,3
2010,5 - 9 años,"Ahogamiento y sumersión, de intención no determinada",10,6,4
2010,5 - 9 años,"Síntomas, signos y hallazgos anormales clínicos y de laboratorio, no clasificados en otra parte",62,40,22
2010,5 - 9 años,Otras causas,305,168,137
2010,10 - 14 años,Exposición a factores no especificados,91,69,22
2010,10 - 14 años,"Agresión con disparo de otras armas de fuego, y las no especificadas",73,42,31
2010,10 - 14 años,"Neumonía, organismo no especificado",69,51,18
2010,10 - 14 años,Diarrea y gastroenteritis de presunto origen infeccioso,37,20,17
2010,10 - 14 años,Secuelas de otros efectos y los no especificados de causas externas,25,15,10
2010,10 - 14 años,Leucemia linfoide,24,13,11
2010,10 - 14 años,Ahogamiento y sumersión no especificados,20,12,8
2010,10 - 14 años,"Disparo de otras armas de fuego, y las no especificadas, de intención no determinada",20,15,5
2010,10 - 14 años,Otras septicemias,17,7,10
2010,10 - 14 años,Epilepsia,17,10,7
2010,10 - 14 años,"Ahogamiento y sumersión, de intención no determinada",17,9,8
2010,10 - 14 años,Insuficiencia renal no especificada,16,9,7
2010,10 - 14 años,"Ahorcamiento, estrangulamiento y sofocación, de intención no determinada",16,12,4
2010,10 - 14 años,"Desnutrición proteicocalórica, no especificada",14,10,4
2010,10 - 14 años,Leucemia de células de tipo no especificado,13,6,7
2010,10 - 14 años,"Síntomas, signos y hallazgos anormales clínicos y de laboratorio, no clasificados en otra parte",50,33,17
2010,10 - 14 años,Otras causas,402,234,168
2010,15 - 19 años,"Agresión con disparo de otras armas de fuego, y las no especificadas",677,605,72
2010,15 - 19 años,Exposición a factores no especificados,185,159,26
2010,15 - 19 años,Secuelas de otros efectos y los no especificados de causas externas,91,79,12
2010,15 - 19 años,"Neumonía, organismo no especificado",88,56,32
2010,15 - 19 años,"Disparo de otras armas de fuego, y las no especificadas, de intención no determinada",73,66,7
2010,15 - 19 años,Agresión con objeto cortante,43,33,10
2010,15 - 19 años,Diarrea y gastroenteritis de presunto origen infeccioso,40,20,20
2010,15 - 19 años,"Ahorcamiento, estrangulamiento y sofocación, de intención no determinada",39,25,14
2010,15 - 19 años,"Ahogamiento y sumersión, de intención no determinada",37,29,8
2010,15 - 19 años,Insuficiencia renal crónica,36,16,20
2010,15 - 19 años,Otras septicemias,29,14,15
2010,15 - 19 años,Infarto agudo del miocardio,29,19,10
2010,15 - 19 años,Ahogamiento y sumersión no especificados,29,25,4
2010,15 - 19 años,"Envenenamiento por, y exposición a otros productos químicos y sustancias nocivas, y los no especificados, de intención no determinada",28,15,13
2010,15 - 19 años,"Envenenamiento por, y exposición a plaguicidas, de intención no determinada",26,15,11
2010,15 - 19 años,"Síntomas, signos y hallazgos anormales clínicos y de laboratorio, no clasificados en otra parte",94,59,35
2010,15 - 19 años,Otras causas,725,386,339
2010,20 - 24 años,"Agresión con disparo de otras armas de fuego, y las no especificadas",896,829,67
2010,20 - 24 años,Exposición a factores no especificados,266,243,23
2010,20 - 24 años,Secuelas de otros efectos y los no especificados de causas externas,119,101,18
2010,20 - 24 años,"Disparo de otras armas de fuego, y las no especificadas, de intención no determinada",119,107,12
2010,20 - 24 años,"Neumonía, organismo no especificado",103,61,42
2010,20 - 24 años,Diarrea y gastroenteritis de presunto origen infeccioso,55,30,25
2010,20 - 24 años,Agresión con objeto cortante,53,45,8
2010,20 - 24 años,"Ahorcamiento, estrangulamiento y sofocación, de intención no determinada",44,34,10
2010,20 - 24 años,Trastornos mentales y del comportamiento debidos al uso de alcohol,43,42,1
2010,20 - 24 años,"Envenenamiento por, y exposición a plaguicidas, de intención no determinada",40,24,16
2010,20 - 24 años,Infarto agudo del miocardio,35,20,15
2010,20 - 24 años,"Envenenamiento por, y exposición a otros productos químicos y sustancias nocivas, y los no especificados, de intención no determinada",35,21,14
2010,20 - 24 años,Insuficiencia renal crónica,33,17,16
2010,20 - 24 años,Otras septicemias,30,13,17
2010,20 - 24 años,"Ahogamiento y sumersión, de intención no determinada",28,25,3
2010,20 - 24 años,"Síntomas, signos y hallazgos anormales clínicos y de laboratorio, no clasificados en otra parte",91,51,40
2010,20 - 24 años,Otras causas,900,494,406
2010,25 - 29 años,"Agresión con disparo de otras armas de fuego, y las no especificadas",781,719,62
2010,25 - 29 años,Exposición a factores no especificados,312,286,26
2010,25 - 29 años,"Disparo de otras armas de fuego, y las no especificadas, de intención no determinada",108,94,14
2010,25 - 29 años,Secuelas de otros efectos y los no especificados de causas externas,105,94,11
2010,25 - 29 años,"Neumonía, organismo no especificado",100,62,38
2010,25 - 29 años,Trastornos mentales y del comportamiento debidos al uso de alcohol,75,72,3
2010,25 - 29 años,Agresión con objeto cortante,66,54,12
2010,25 - 29 años,Diarrea y gastroenteritis de presunto origen infeccioso,53,34,19
2010,25 - 29 años,Infarto agudo del miocardio,51,31,20
2010,25 - 29 años,Fibrosis y cirrosis del hígado,41,39,2
2010,25 - 29 años,"Enfermedad por virus de la inmunodeficiencia humana [VIH], resultante en enfermedades infecciosas y parasitarias",40,26,14
2010,25 - 29 años,"Enfermedad por virus de la inmunodeficiencia humana [VIH], sin otra especificación",40,26,14
2010,25 - 29 años,"Diabetes mellitus, no especificada",37,17,20
2010,25 - 29 años,"Ahorcamiento, estrangulamiento y sofocación, de intención no determinada",35,29,6
2010,25 - 29 años,Insuficiencia renal crónica,31,21,10
2010,25 - 29 años,"Síntomas, signos y hallazgos anormales clínicos y de laboratorio, no clasificados en otra parte",99,55,44
2010,25 - 29 años,Otras causas,987,558,429
2010,30 - 34 años,"Agresión con disparo de otras armas de fuego, y las no especificadas",629,577,52
2010,30 - 34 años,Exposición a factores no especificados,245,218,27
2010,30 - 34 años,Trastornos mentales y del comportamiento debidos al uso de alcohol,125,114,11
2010,30 - 34 años,"Neumonía, organismo no especificado",111,76,35
2010,30 - 34 años,Secuelas de otros efectos y los no especificados de causas externas,96,84,12
2010,30 - 34 años,"Disparo de otras armas de fuego, y las no especificadas, de intención no determinada",82,67,15
2010,30 - 34 años,Fibrosis y cirrosis del hígado,74,61,13
2010,30 - 34 años,Enfermedad alcohólica del hígado,58,56,2
2010,30 - 34 años,Infarto agudo del miocardio,57,34,23
2010,30 - 34 años,"Enfermedad por virus de la inmunodeficiencia humana [VIH], resultante en enfermedades infecciosas y parasitarias",53,38,15
2010,30 - 34 años,Agresión con objeto cortante,50,46,4
2010,30 - 34 años,Diarrea y gastroenteritis de presunto origen infeccioso,49,24,25
2010,30 - 34 años,"Diabetes mellitus, no especificada",49,23,26
2010,30 - 34 años,"Enfermedad por virus de la inmunodeficiencia humana [VIH], sin otra especificación",46,34,12
2010,30 - 34 años,"Ahorcamiento, estrangulamiento y sofocación, de intención no determinada",41,33,8
2010,30 - 34 años,"Síntomas, signos y hallazgos anormales clínicos y de laboratorio, no clasificados en otra parte",123,73,50
2010,30 - 34 años,Otras causas,1063,589,474
2010,35 - 39 años,"Agresión con disparo de otras armas de fuego, y las no especificadas",461,411,50
2010,35 - 39 años,Exposición a factores no especificados,189,159,30
2010,35 - 39 años,Trastornos mentales y del comportamiento debidos al uso de alcohol,158,145,13
2010,35 - 39 años,Fibrosis y cirrosis del hígado,111,88,23
2010,35 - 39 años,"Neumonía, organismo no especificado",100,60,40
2010,35 - 39 años,Secuelas de otros efectos y los no especificados de causas externas,85,72,13
2010,35 - 39 años,Infarto agudo del miocardio,77,48,29
2010,35 - 39 años,Enfermedad alcohólica del hígado,76,70,6
2010,35 - 39 años,Diarrea y gastroenteritis de presunto origen infeccioso,54,29,25
2010,35 - 39 años,"Diabetes mellitus, no especificada",54,35,19
2010,35 - 39 años,"Disparo de otras armas de fuego, y las no especificadas, de intención no determinada",45,40,5
2010,35 - 39 años,"Enfermedad por virus de la inmunodeficiencia humana [VIH], sin otra especificación",43,31,12
2010,35 - 39 años,Tumor maligno del estómago,40,19,21
2010,35 - 39 años,Agresión con objeto cortante,39,33,6
2010,35 - 39 años,"Enfermedad por virus de la inmunodeficiencia humana [VIH], resultante en enfermedades infecciosas y parasitarias",37,21,16
2010,35 - 39 años,"Síntomas, signos y hallazgos anormales clínicos y de laboratorio, no clasificados en otra parte",119,70,49
2010,35 - 39 años,Otras causas,987,518,469
2010,40 - 44 años,"Agresión con disparo de otras armas de fuego, y las no especificadas",283,245,38
2010,40 - 44 años,Exposición a factores no especificados,188,161,27
2010,40 - 44 años,Trastornos mentales y del comportamiento debidos al uso de alcohol,152,140,12
2010,40 - 44 años,Fibrosis y cirrosis del hígado,131,102,29
2010,40 - 44 años,Infarto agudo del miocardio,128,87,41
2010,40 - 44 años,"Neumonía, organismo no especificado",122,73,49
2010,40 - 44 años,"Diabetes mellitus, no especificada",100,49,51
2010,40 - 44 años,Enfermedad alcohólica del hígado,90,77,13
2010,40 - 44 años,Secuelas de otros efectos y los no especificados de causas externas,79,69,10
2010,40 - 44 años,Diarrea y gastroenteritis de presunto origen infeccioso,53,28,25
2010,40 - 44 años,Tumor maligno del estómago,48,21,27
2010,40 - 44 años,"Disparo de otras armas de fuego, y las no especificadas, de intención no determinada",38,35,3
2010,40 - 44 años,Insuficiencia renal crónica,34,24,10
2010,40 - 44 años,Agresión con objeto cortante,33,29,4
2010,40 - 44 años,"Síntomas, signos y hallazgos anormales clínicos y de laboratorio, no clasificados en otra parte",94,58,36
2010,40 - 44 años,Otras causas,1009,577,432
2010,45 - 49 años,"Agresión con disparo de otras armas de fuego, y las no especificadas",252,212,40
2010,45 - 49 años,Exposición a factores no especificados,182,153,29
2010,45 - 49 años,"Diabetes mellitus, no especificada",176,83,93
2010,45 - 49 años,Fibrosis y cirrosis del hígado,175,135,40
2010,45 - 49 años,Trastornos mentales y del comportamiento debidos al uso de alcohol,148,134,14
2010,45 - 49 años,Infarto agudo del miocardio,132,82,50
2010,45 - 49 años,"Neumonía, organismo no especificado",127,79,48
2010,45 - 49 años,Enfermedad alcohólica del hígado,73,62,11
2010,45 - 49 años,Tumor maligno del estómago,66,31,35
2010,45 - 49 años,Tumor maligno del hígado y de las vías biliares intrahepáticas,62,20,42
2010,45 - 49 años,Diabetes mellitus no insulinodependiente,53,22,31
2010,45 - 49 años,Secuelas de otros efectos y los no especificados de causas externas,46,37,9
2010,45 - 49 años,"Accidente vascular encefálico agudo, no especificado como hemorrágico o isquémico",42,20,22
2010,45 - 49 años,"Síntomas, signos y hallazgos anormales clínicos y de laboratorio, no clasificados en otra parte",116,63,53
2010,45 - 49 años,Otras causas,119,666,524
2010,50 - 54 años,"Diabetes mellitus, no especificada",300,126,174
2010,50 - 54 años,Fibrosis y cirrosis del hígado,223,159,64
2010,50 - 54 años,"Agresión con disparo de otras armas de fuego, y las no especificadas",176,149,27
2010,50 - 54 años,Infarto agudo del miocardio,172,93,79
2010,50 - 54 años,"Neumonía, organismo no especificado",164,90,74
2010,50 - 54 años,Exposición a factores no especificados,155,132,23
2010,50 - 54 años,Trastornos mentales y del comportamiento debidos al uso de alcohol,144,135,9
2010,50 - 54 años,Tumor maligno del estómago,101,39,62
2010,50 - 54 años,Diabetes mellitus no insulinodependiente,99,47,52
2010,50 - 54 años,Tumor maligno del hígado y de las vías biliares intrahepáticas,77,30,47
2010,50 - 54 años,Enfermedad alcohólica del hígado,73,63,10
2010,50 - 54 años,Insuficiencia renal crónica,67,32,35
2010,50 - 54 años,Secuelas de otros efectos y los no especificados de causas externas,63,52,11
2010,50 - 54 años,Diarrea y gastroenteritis de presunto origen infeccioso,53,23,30
2010,50 - 54 años,"Síntomas, signos y hallazgos anormales clínicos y de laboratorio, no clasificados en otra parte",131,80,51
2010,50 - 54 años,Otras causas,131,706,604
2010,55 - 59 años,"Diabetes mellitus, no especificada",389,165,224
2010,55 - 59 años,Fibrosis y cirrosis del hígado,226,141,85
2010,55 - 59 años,Infarto agudo del miocardio,221,133,88
2010,55 - 59 años,"Neumonía, organismo no especificado",210,101,109
2010,55 - 59 años,Exposición a factores no especificados,143,114,29
2010,55 - 59 años,"Agresión con disparo de otras armas de fuego, y las no especificadas",121,99,22
2010,55 - 59 años,Diabetes mellitus no insulinodependiente,119,53,66
2010,55 - 59 años,Tumor maligno del hígado y de las vías biliares intrahepáticas,110,47,63
2010,55 - 59 años,Tumor maligno del estómago,108,52,56
2010,55 - 59 años,Trastornos mentales y del comportamiento debidos al uso de alcohol,104,92,12
2010,55 - 59 años,Insuficiencia renal crónica,85,40,45
2010,55 - 59 años,Diarrea y gastroenteritis de presunto origen infeccioso,79,39,40
2010,55 - 59 años,"Accidente vascular encefálico agudo, no especificado como hemorrágico o isquémico",79,38,41
2010,55 - 59 años,Enfermedad alcohólica del hígado,76,66,10
2010,55 - 59 años,Insuficiencia renal no especificada,64,36,28
2010,55 - 59 años,"Síntomas, signos y hallazgos anormales clínicos y de laboratorio, no clasificados en otra parte",166,87,79
2010,55 - 59 años,Otras causas,1461,748,713
2010,60 - 64 años,"Diabetes mellitus, no especificada",416,166,250
2010,60 - 64 años,Infarto agudo del miocardio,267,153,114
2010,60 - 64 años,"Neumonía, organismo no especificado",251,129,122
2010,60 - 64 años,Fibrosis y cirrosis del hígado,189,117,72
2010,60 - 64 años,Diabetes mellitus no insulinodependiente,158,67,91
2010,60 - 64 años,Tumor maligno del estómago,141,69,72
2010,60 - 64 años,Tumor maligno del hígado y de las vías biliares intrahepáticas,141,59,82
2010,60 - 64 años,Exposición a factores no especificados,140,116,24
2010,60 - 64 años,"Accidente vascular encefálico agudo, no especificado como hemorrágico o isquémico",108,44,64
2010,60 - 64 años,Insuficiencia renal crónica,101,59,42
2010,60 - 64 años,"Agresión con disparo de otras armas de fuego, y las no especificadas",89,78,11
2010,60 - 64 años,Trastornos mentales y del comportamiento debidos al uso de alcohol,85,76,9
2010,60 - 64 años,Diarrea y gastroenteritis de presunto origen infeccioso,78,43,35
2010,60 - 64 años,"Desnutrición proteicocalórica, no especificada",78,38,40
2010,60 - 64 años,Insuficiencia cardíaca,78,39,39
2010,60 - 64 años,"Síntomas, signos y hallazgos anormales clínicos y de laboratorio, no clasificados en otra parte",188,107,81
2010,60 - 64 años,Otras causas,1481,778,703
2010,65 - 69 años,"Diabetes mellitus, no especificada",418,186,232
2010,65 - 69 años,"Neumonía, organismo no especificado",341,171,170
2010,65 - 69 años,Infarto agudo del miocardio,296,159,137
2010,65 - 69 años,Fibrosis y cirrosis del hígado,198,116,82
2010,65 - 69 años,Tumor maligno del estómago,167,80,87
2010,65 - 69 años,Diabetes mellitus no insulinodependiente,140,44,96
2010,65 - 69 años,Tumor maligno del hígado y de las vías biliares intrahepáticas,118,52,66
2010,65 - 69 años,Insuficiencia cardíaca,107,59,48
2010,65 - 69 años,"Accidente vascular encefálico agudo, no especificado como hemorrágico o isquémico",104,51,53
2010,65 - 69 años,Exposición a factores no especificados,102,76,26
2010,65 - 69 años,"Desnutrición proteicocalórica, no especificada",100,56,44
2010,65 - 69 años,Insuficiencia renal crónica,98,51,47
2010,65 - 69 años,Diarrea y gastroenteritis de presunto origen infeccioso,93,38,55
2010,65 - 69 años,Insuficiencia renal no especificada,64,22,42
2010,65 - 69 años,Otras enfermedades cerebrovasculares,58,26,32
2010,65 - 69 años,"Síntomas, signos y hallazgos anormales clínicos y de laboratorio, no clasificados en otra parte",254,121,133
2010,65 - 69 años,Otras causas,158,870,710
2010,70 - 74 años,"Neumonía, organismo no especificado",472,241,231
2010,70 - 74 años,"Diabetes mellitus, no especificada",442,179,263
2010,70 - 74 años,Infarto agudo del miocardio,398,209,189
2010,70 - 74 años,Tumor maligno del estómago,206,89,117
2010,70 - 74 años,"Accidente vascular encefálico agudo, no especificado como hemorrágico o isquémico",176,97,79
2010,70 - 74 años,Insuficiencia cardíaca,161,89,72
2010,70 - 74 años,Tumor maligno del hígado y de las vías biliares intrahepáticas,153,72,81
2010,70 - 74 años,Fibrosis y cirrosis del hígado,152,80,72
2010,70 - 74 años,Diabetes mellitus no insulinodependiente,142,64,78
2010,70 - 74 años,Diarrea y gastroenteritis de presunto origen infeccioso,135,65,70
2010,70 - 74 años,"Desnutrición proteicocalórica, no especificada",119,62,57
2010,70 - 74 años,Insuficiencia renal crónica,100,50,50
2010,70 - 74 años,Exposición a factores no especificados,99,74,25
2010,70 - 74 años,Otras enfermedades cerebrovasculares,81,42,39
2010,70 - 74 años,"Síntomas, signos y hallazgos anormales clínicos y de laboratorio, no clasificados en otra parte",368,190,178
2010,70 - 74 años,Otras causas,1666,885,781
2010,75 - 79 años,"Neumonía, organismo no especificado",568,299,269
2010,75 - 79 años,Infarto agudo del miocardio,425,240,185
2010,75 - 79 años,"Diabetes mellitus, no especificada",392,155,237
2010,75 - 79 años,Insuficiencia cardíaca,253,128,125
2010,75 - 79 años,"Accidente vascular encefálico agudo, no especificado como hemorrágico o isquémico",222,114,108
2010,75 - 79 años,Tumor maligno del estómago,179,79,100
2010,75 - 79 años,"Desnutrición proteicocalórica, no especificada",174,84,90
2010,75 - 79 años,Tumor maligno del hígado y de las vías biliares intrahepáticas,168,74,94
2010,75 - 79 años,Fibrosis y cirrosis del hígado,130,70,60
2010,75 - 79 años,Diabetes mellitus no insulinodependiente,123,43,80
2010,75 - 79 años,Exposición a factores no especificados,119,75,44
2010,75 - 79 años,Diarrea y gastroenteritis de presunto origen infeccioso,118,54,64
2010,75 - 79 años,Insuficiencia renal crónica,99,57,42
2010,75 - 79 años,Otras enfermedades cerebrovasculares,95,51,44
2010,75 - 79 años,Otras enfermedades pulmonares obstructivas crónicas,86,51,35
2010,75 - 79 años,"Síntomas, signos y hallazgos anormales clínicos y de laboratorio, no clasificados en otra parte",448,224,224
2010,75 - 79 años,Otras causas,1865,1021,844
2010,80 - 84 años,"Neumonía, organismo no especificado",763,413,350
2010,80 - 84 años,Infarto agudo del miocardio,601,290,311
2010,80 - 84 años,Insuficiencia cardíaca,348,171,177
2010,80 - 84 años,"Diabetes mellitus, no especificada",329,144,185
2010,80 - 84 años,"Desnutrición proteicocalórica, no especificada",282,125,157
2010,80 - 84 años,"Accidente vascular encefálico agudo, no especificado como hemorrágico o isquémico",262,134,128
2010,80 - 84 años,Tumor maligno del estómago,190,94,96
2010,80 - 84 años,Otras enfermedades cerebrovasculares,117,68,49
2010,80 - 84 años,Tumor maligno del hígado y de las vías biliares intrahepáticas,116,47,69
2010,80 - 84 años,Diarrea y gastroenteritis de presunto origen infeccioso,115,59,56
2010,80 - 84 años,Otras enfermedades pulmonares obstructivas crónicas,115,61,54
2010,80 - 84 años,Diabetes mellitus no insulinodependiente,109,38,71
2010,80 - 84 años,Insuficiencia renal crónica,101,57,44
2010,80 - 84 años,Exposición a factores no especificados,100,53,47
2010,80 - 84 años,"Síntomas, signos y hallazgos anormales clínicos y de laboratorio, no clasificados en otra parte",705,336,369
2010,80 - 84 años,Otras causas,1892,932,960
2010,85 y más,"Neumonía, organismo no especificado",1117,560,557
2010,85 y más,Infarto agudo del miocardio,911,449,462
2010,85 y más,Insuficiencia cardíaca,568,280,288
2010,85 y más,"Desnutrición proteicocalórica, no especificada",383,160,223
2010,85 y más,"Accidente vascular encefálico agudo, no especificado como hemorrágico o isquémico",365,177,188
2010,85 y más,"Diabetes mellitus, no especificada",265,95,170
2010,85 y más,Otras enfermedades pulmonares obstructivas crónicas,172,86,86
2010,85 y más,Tumor maligno del estómago,171,78,93
2010,85 y más,Diarrea y gastroenteritis de presunto origen infeccioso,145,61,84
2010,85 y más,Hipertensión esencial (primaria),137,54,83
2010,85 y más,Exposición a factores no especificados,129,69,60
2010,85 y más,Otras enfermedades cerebrovasculares,124,54,70
2010,85 y más,Insuficiencia renal no especificada,106,55,51
2010,85 y más,Insuficiencia renal crónica,85,48,37
2010,85 y más,"Síntomas, signos y hallazgos anormales clínicos y de laboratorio, no clasificados en otra parte",1198,521,677
2010,85 y más,Otras causas,198,891,1089
2011,1- 6 días,Dificultad respiratoria del recién nacido,303,186,117
2011,1- 6 días,Síndromes de aspiración neonatal,146,77,69
2011,1- 6 días,Sepsis bacteriana del recién nacido,136,74,62
2011,1- 6 días,Asfixia del nacimiento,113,60,53
2011,1- 6 días,"Trastornos relacionados con duración corta de la gestación y con bajo peso al nacer, no clasificados en otra parte",99,55,44
2011,1- 6 días,"Otras malformaciones congénitas, no clasificadas en otra parte",96,59,37
2011,1- 6 días,Neumonía congénita,89,45,44
2011,1- 6 días,Otras malformaciones congénitas del corazón,49,25,24
2011,1- 6 días,Trastornos cardiovasculares originados en el período perinatal,48,33,15
2011,1- 6 días,Coagulación intravascular diseminada en el feto y el recién nacido,26,21,5
2011,1- 6 días,Anencefalia y malformaciones congénitas similares,24,11,13
2011,1- 6 días,"Enfisema intersticial y afecciones relacionadas, originadas en el período perinatal",17,10,7
2011,1- 6 días,Hemorragia intracraneal no traumática del feto y del recién nacido,17,12,5
2011,1- 6 días,Hipoxia intrauterina,15,9,6
2011,1- 6 días,"Neumonía, organismo no especificado",13,8,5
2011,1- 6 días,"Síntomas, signos y hallazgos anormales clínicos y de laboratorio, no clasificados en otra parte",45,30,15
2011,1- 6 días,Otras causas,245,145,100
2011,7 - 27 días,Sepsis bacteriana del recién nacido,262,151,111
2011,7 - 27 días,Neumonía congénita,210,113,97
2011,7 - 27 días,Dificultad respiratoria del recién nacido,142,83,59
2011,7 - 27 días,Síndromes de aspiración neonatal,109,59,50
2011,7 - 27 días,Asfixia del nacimiento,81,45,36
2011,7 - 27 días,Enterocolitis necrotizante del feto y del recién nacido,79,49,30
2011,7 - 27 días,Coagulación intravascular diseminada en el feto y el recién nacido,75,39,36
2011,7 - 27 días,"Otras malformaciones congénitas, no clasificadas en otra parte",69,37,32
2011,7 - 27 días,"Trastornos relacionados con duración corta de la gestación y con bajo peso al nacer, no clasificados en otra parte",60,26,34
2011,7 - 27 días,Otras malformaciones congénitas del corazón,41,22,19
2011,7 - 27 días,"Neumonía, organismo no especificado",35,21,14
2011,7 - 27 días,Trastornos cardiovasculares originados en el período perinatal,31,17,14
2011,7 - 27 días,"Malformaciones congénitas del sistema osteomuscular, no clasificadas en otra parte",28,18,10
2011,7 - 27 días,Hemorragia pulmonar originada en el período perinatal,24,13,11
2011,7 - 27 días,Otras hemorragias neonatales,20,11,9
2011,7 - 27 días,"Síntomas, signos y hallazgos anormales clínicos y de laboratorio, no clasificados en otra parte",57,34,23
2011,7 - 27 días,Otras causas,361,200,161
2011,28 días a menos de 1 año,"Neumonía, organismo no especificado",143,797,633
2011,28 días a menos de 1 año,Diarrea y gastroenteritis de presunto origen infeccioso,432,241,191
2011,28 días a menos de 1 año,Otras septicemias,242,128,114
2011,28 días a menos de 1 año,Otras malformaciones congénitas del corazón,126,70,56
2011,28 días a menos de 1 año,"Desnutrición proteicocalórica, no especificada",95,57,38
2011,28 días a menos de 1 año,Sepsis bacteriana del recién nacido,70,42,28
2011,28 días a menos de 1 año,"Otras malformaciones congénitas, no clasificadas en otra parte",67,33,34
2011,28 días a menos de 1 año,Obstrucción no especificada de la respiración,60,38,22
2011,28 días a menos de 1 año,"Desnutrición proteicocalórica severa, no especificada",55,31,24
2011,28 días a menos de 1 año,"Neumonía bacteriana, no clasificada en otra parte",42,23,19
2011,28 días a menos de 1 año,Dificultad respiratoria del recién nacido,38,18,20
2011,28 días a menos de 1 año,Coagulación intravascular diseminada [síndrome de desfibrinación],37,22,15
2011,28 días a menos de 1 año,Síndrome de dificultad respiratoria del adulto,37,24,13
2011,28 días a menos de 1 año,Bronquitis aguda,36,20,16
2011,28 días a menos de 1 año,Otros trastornos respiratorios,36,20,16
2011,28 días a menos de 1 año,"Síntomas, signos y hallazgos anormales clínicos y de laboratorio, no clasificados en otra parte",294,193,101
2011,28 días a menos de 1 año,Otras causas,1028,571,457
2011,1 año,"Neumonía, organismo no especificado",426,223,203
2011,1 año,Diarrea y gastroenteritis de presunto origen infeccioso,390,199,191
2011,1 año,Otras septicemias,58,28,30
2011,1 año,"Desnutrición proteicocalórica, no especificada",47,27,20
2011,1 año,Depleción del volumen,30,18,12
2011,1 año,"Desnutrición proteicocalórica severa, no especificada",28,15,13
2011,1 año,Otras malformaciones congénitas del corazón,17,9,8
2011,1 año,Epilepsia,16,6,10
2011,1 año,Ahogamiento y sumersión no especificados,15,13,2
2011,1 año,Otros trastornos del encéfalo,14,8,6
2011,1 año,"Otros trastornos de los líquidos, de los electrólitos y del equilibrio ácido-básico",12,6,6
2011,1 año,"Parasitosis intestinal, sin otra especificación",11,5,6
2011,1 año,Bronquitis aguda,11,6,5
2011,1 año,Síndrome de Down,11,4,7
2011,1 año,Exposición a factores no especificados,11,6,5
2011,1 año,"Síntomas, signos y hallazgos anormales clínicos y de laboratorio, no clasificados en otra parte",112,63,49
2011,1 año,Otras causas,295,148,147
2011,2 años,"Neumonía, organismo no especificado",130,63,67
2011,2 años,Diarrea y gastroenteritis de presunto origen infeccioso,124,52,72
2011,2 años,Exposición a factores no especificados,20,13,7
2011,2 años,"Desnutrición proteicocalórica, no especificada",15,5,10
2011,2 años,Obstrucción no especificada de la respiración,12,8,4
2011,2 años,Otras septicemias,10,7,3
2011,2 años,Depleción del volumen,10,5,5
2011,2 años,Ahogamiento y sumersión no especificados,10,4,6
2011,2 años,"Desnutrición proteicocalórica severa, no especificada",8,4,4
2011,2 años,Asma,7,2,5
2011,2 años,"Otros trastornos de los líquidos, de los electrólitos y del equilibrio ácido-básico",5,1,4
2011,2 años,Hidrocéfalo,5,3,2
2011,2 años,Ileo paralítico y obstrucción intestinal sin hernia,5,3,2
2011,2 años,"Insuficiencia hepática, no clasificada en otra parte",5,4,1
2011,2 años,Secuelas de otros efectos y los no especificados de causas externas,5,2,3
2011,2 años,"Síntomas, signos y hallazgos anormales clínicos y de laboratorio, no clasificados en otra parte",48,30,18
2011,2 años,Otras causas,119,59,60
2011,3 años,"Neumonía, organismo no especificado",68,34,34
2011,3 años,Diarrea y gastroenteritis de presunto origen infeccioso,46,20,26
2011,3 años,Otras septicemias,19,8,11
2011,3 años,Exposición a factores no especificados,14,10,4
2011,3 años,"Desnutrición proteicocalórica severa, no especificada",9,5,4
2011,3 años,"Desnutrición proteicocalórica, no especificada",9,5,4
2011,3 años,Otros trastornos del encéfalo,7,5,2
2011,3 años,"Exposición a humos, fuegos o llamas no especificados",6,3,3
2011,3 años,Ahogamiento y sumersión no especificados,5,4,1
2011,3 años,Epilepsia,4,1,3
2011,3 años,Parálisis cerebral,4,1,3
2011,3 años,Otras malformaciones congénitas del corazón,4,2,2
2011,3 años,Obstrucción no especificada de la respiración,4,3,1
2011,3 años,Depleción del volumen,3,1,2
2011,3 años,"Síntomas, signos y hallazgos anormales clínicos y de laboratorio, no clasificados en otra parte",26,15,11
2011,3 años,Otras causas,78,36,42
2011,4 años,"Neumonía, organismo no especificado",40,21,19
2011,4 años,Diarrea y gastroenteritis de presunto origen infeccioso,27,17,10
2011,4 años,Exposición a factores no especificados,14,9,5
2011,4 años,Otras septicemias,6,3,3
2011,4 años,"Parasitosis intestinal, sin otra especificación",5,2,3
2011,4 años,Depleción del volumen,5,1,4
2011,4 años,Hidrocéfalo,4,3,1
2011,4 años,Ahogamiento y sumersión no especificados,4,2,2
2011,4 años,"Desnutrición proteicocalórica severa, no especificada",3,2,1
2011,4 años,"Síntomas, signos y hallazgos anormales clínicos y de laboratorio, no clasificados en otra parte",18,9,9
2011,4 años,Otras causas,56,29,27
2011,5 - 9 años,"Neumonía, organismo no especificado",91,41,50
2011,5 - 9 años,Diarrea y gastroenteritis de presunto origen infeccioso,75,38,37
2011,5 - 9 años,Exposición a factores no especificados,52,34,18
2011,5 - 9 años,Secuelas de otros efectos y los no especificados de causas externas,29,19,10
2011,5 - 9 años,Otras septicemias,20,10,10
2011,5 - 9 años,"Desnutrición proteicocalórica, no especificada",17,10,7
2011,5 - 9 años,Ahogamiento y sumersión no especificados,17,12,5
2011,5 - 9 años,Leucemia de células de tipo no especificado,16,11,5
2011,5 - 9 años,Leucemia linfoide,12,9,3
2011,5 - 9 años,Otros trastornos del encéfalo,12,8,4
2011,5 - 9 años,Tumor maligno del encéfalo,9,3,6
2011,5 - 9 años,Epilepsia,9,6,3
2011,5 - 9 años,Parálisis cerebral,9,4,5
2011,5 - 9 años,Hidrocéfalo,9,4,5
2011,5 - 9 años,Otras malformaciones congénitas del corazón,8,6,2
2011,5 - 9 años,"Síntomas, signos y hallazgos anormales clínicos y de laboratorio, no clasificados en otra parte",56,31,25
2011,5 - 9 años,Otras causas,264,141,123
2011,10 - 14 años,"Neumonía, organismo no especificado",75,36,39
2011,10 - 14 años,Exposición a factores no especificados,73,56,17
2011,10 - 14 años,Secuelas de otros efectos y los no especificados de causas externas,51,30,21
2011,10 - 14 años,"Agresión con disparo de otras armas de fuego, y las no especificadas",40,31,9
2011,10 - 14 años,Diarrea y gastroenteritis de presunto origen infeccioso,37,23,14
2011,10 - 14 años,"Disparo de otras armas de fuego, y las no especificadas",30,22,8
2011,10 - 14 años,Epilepsia,28,17,11
2011,10 - 14 años,Ahogamiento y sumersión no especificados,27,14,13
2011,10 - 14 años,Otras septicemias,17,11,6
2011,10 - 14 años,Leucemia linfoide,17,8,9
2011,10 - 14 años,Obstrucción no especificada de la respiración,17,7,10
2011,10 - 14 años,Otros estrangulamientos y ahorcamientos accidentales,14,6,8
2011,10 - 14 años,Leucemia de células de tipo no especificado,13,4,9
2011,10 - 14 años,"Desnutrición proteicocalórica, no especificada",12,7,5
2011,10 - 14 años,Insuficiencia renal crónica,12,8,4
2011,10 - 14 años,"Síntomas, signos y hallazgos anormales clínicos y de laboratorio, no clasificados en otra parte",57,30,27
2011,10 - 14 años,Otras causas,387,192,195
2011,15 - 19 años,"Agresión con disparo de otras armas de fuego, y las no especificadas",496,434,62
2011,15 - 19 años,"Disparo de otras armas de fuego, y las no especificadas",211,184,27
2011,15 - 19 años,Exposición a factores no especificados,202,176,26
2011,15 - 19 años,Secuelas de otros efectos y los no especificados de causas externas,90,68,22
2011,15 - 19 años,"Neumonía, organismo no especificado",86,50,36
2011,15 - 19 años,Ahogamiento y sumersión no especificados,55,50,5
2011,15 - 19 años,Otros estrangulamientos y ahorcamientos accidentales,38,22,16
2011,15 - 19 años,Epilepsia,36,24,12
2011,15 - 19 años,Agresión con objeto cortante,36,26,10
2011,15 - 19 años,Agresión por medios no especificados,36,28,8
2011,15 - 19 años,Diarrea y gastroenteritis de presunto origen infeccioso,34,19,15
2011,15 - 19 años,"Envenenamiento accidental por, y exposición a otros productos químicos y sustancias nocivas, y los no especificados",33,11,22
2011,15 - 19 años,"Lesión autoinfligida intencionalmente por ahorcamiento, estrangulamiento o sofocación",33,25,8
2011,15 - 19 años,"Envenenamiento autoinfligido intencionalmente por, y exposición a plaguicidas",30,10,20
2011,15 - 19 años,Obstrucción no especificada de la respiración,29,18,11
2011,15 - 19 años,"Síntomas, signos y hallazgos anormales clínicos y de laboratorio, no clasificados en otra parte",103,57,46
2011,15 - 19 años,Otras causas,733,379,354
2011,20 - 24 años,"Agresión con disparo de otras armas de fuego, y las no especificadas",654,611,43
2011,20 - 24 años,Exposición a factores no especificados,312,281,31
2011,20 - 24 años,"Disparo de otras armas de fuego, y las no especificadas",230,212,18
2011,20 - 24 años,Secuelas de otros efectos y los no especificados de causas externas,118,101,17
2011,20 - 24 años,"Neumonía, organismo no especificado",85,50,35
2011,20 - 24 años,Ahogamiento y sumersión no especificados,59,51,8
2011,20 - 24 años,Otros estrangulamientos y ahorcamientos accidentales,52,42,10
2011,20 - 24 años,"Envenenamiento accidental por, y exposición a otros productos químicos y sustancias nocivas, y los no especificados",42,26,16
2011,20 - 24 años,Agresión con objeto cortante,40,36,4
2011,20 - 24 años,"Envenenamiento accidental por, y exposición a plaguicidas",38,28,10
2011,20 - 24 años,Diarrea y gastroenteritis de presunto origen infeccioso,34,18,16
2011,20 - 24 años,Epilepsia,32,19,13
2011,20 - 24 años,Infarto agudo del miocardio,30,21,9
2011,20 - 24 años,Otras septicemias,29,16,13
2011,20 - 24 años,"Síntomas, signos y hallazgos anormales clínicos y de laboratorio, no clasificados en otra parte",119,68,51
2011,20 - 24 años,Otras causas,831,498,333
2011,25 - 29 años,"Agresión con disparo de otras armas de fuego, y las no especificadas",601,558,43
2011,25 - 29 años,Exposición a factores no especificados,313,285,28
2011,25 - 29 años,"Disparo de otras armas de fuego, y las no especificadas",217,201,16
2011,25 - 29 años,Secuelas de otros efectos y los no especificados de causas externas,134,110,24
2011,25 - 29 años,"Neumonía, organismo no especificado",89,52,37
2011,25 - 29 años,Agresión con objeto cortante,63,55,8
2011,25 - 29 años,"Enfermedad por virus de la inmunodeficiencia humana [VIH], sin otra especificación",54,37,17
2011,25 - 29 años,"Envenenamiento accidental por, y exposición al alcohol",52,51,1
2011,25 - 29 años,Otros estrangulamientos y ahorcamientos accidentales,50,40,10
2011,25 - 29 años,Diarrea y gastroenteritis de presunto origen infeccioso,49,32,17
2011,25 - 29 años,Infarto agudo del miocardio,49,32,17
2011,25 - 29 años,Fibrosis y cirrosis del hígado,44,40,4
2011,25 - 29 años,Enfermedad alcohólica del hígado,38,34,4
2011,25 - 29 años,"Envenenamiento accidental por, y exposición a otros productos químicos y sustancias nocivas, y los no especificados",33,25,8
2011,25 - 29 años,"Enfermedad por virus de la inmunodeficiencia humana [VIH], resultante en enfermedades infecciosas y parasitarias",32,25,7
2011,25 - 29 años,"Síntomas, signos y hallazgos anormales clínicos y de laboratorio, no clasificados en otra parte",108,58,50
2011,25 - 29 años,Otras causas,938,532,406
2011,30 - 34 años,"Agresión con disparo de otras armas de fuego, y las no especificadas",482,432,50
2011,30 - 34 años,Exposición a factores no especificados,261,232,29
2011,30 - 34 años,"Disparo de otras armas de fuego, y las no especificadas",186,168,18
2011,30 - 34 años,"Neumonía, organismo no especificado",103,57,46
2011,30 - 34 años,Secuelas de otros efectos y los no especificados de causas externas,81,68,13
2011,30 - 34 años,"Envenenamiento accidental por, y exposición al alcohol",80,76,4
2011,30 - 34 años,Infarto agudo del miocardio,74,41,33
2011,30 - 34 años,Fibrosis y cirrosis del hígado,72,61,11
2011,30 - 34 años,Enfermedad alcohólica del hígado,71,62,9
2011,30 - 34 años,"Enfermedad por virus de la inmunodeficiencia humana [VIH], sin otra especificación",59,44,15
2011,30 - 34 años,Diarrea y gastroenteritis de presunto origen infeccioso,53,32,21
2011,30 - 34 años,"Diabetes mellitus, no especificada",46,21,25
2011,30 - 34 años,Trastornos mentales y del comportamiento debidos al uso de alcohol,44,39,5
2011,30 - 34 años,Agresión con objeto cortante,44,35,9
2011,30 - 34 años,"Enfermedad por virus de la inmunodeficiencia humana [VIH], resultante en enfermedades infecciosas y parasitarias",41,29,12
2011,30 - 34 años,"Síntomas, signos y hallazgos anormales clínicos y de laboratorio, no clasificados en otra parte",102,67,35
2011,30 - 34 años,Otras causas,102,587,433
2011,35 - 39 años,"Agresión con disparo de otras armas de fuego, y las no especificadas",345,305,40
2011,35 - 39 años,Exposición a factores no especificados,224,197,27
2011,35 - 39 años,"Disparo de otras armas de fuego, y las no especificadas",119,106,13
2011,35 - 39 años,Fibrosis y cirrosis del hígado,117,102,15
2011,35 - 39 años,Infarto agudo del miocardio,101,63,38
2011,35 - 39 años,"Neumonía, organismo no especificado",86,57,29
2011,35 - 39 años,Secuelas de otros efectos y los no especificados de causas externas,82,70,12
2011,35 - 39 años,Enfermedad alcohólica del hígado,75,63,12
2011,35 - 39 años,"Diabetes mellitus, no especificada",72,34,38
2011,35 - 39 años,Trastornos mentales y del comportamiento debidos al uso de alcohol,69,61,8
2011,35 - 39 años,"Envenenamiento accidental por, y exposición al alcohol",68,60,8
2011,35 - 39 años,"Enfermedad por virus de la inmunodeficiencia humana [VIH], sin otra especificación",38,25,13
2011,35 - 39 años,Tumor maligno del estómago,37,15,22
2011,35 - 39 años,Agresión con objeto cortante,32,28,4
2011,35 - 39 años,Diarrea y gastroenteritis de presunto origen infeccioso,31,14,17
2011,35 - 39 años,"Síntomas, signos y hallazgos anormales clínicos y de laboratorio, no clasificados en otra parte",117,70,47
2011,35 - 39 años,Otras causas,1067,585,482
2011,40 - 44 años,"Agresión con disparo de otras armas de fuego, y las no especificadas",242,215,27
2011,40 - 44 años,Exposición a factores no especificados,177,155,22
2011,40 - 44 años,Fibrosis y cirrosis del hígado,134,105,29
2011,40 - 44 años,"Diabetes mellitus, no especificada",110,54,56
2011,40 - 44 años,Infarto agudo del miocardio,109,65,44
2011,40 - 44 años,Enfermedad alcohólica del hígado,102,87,15
2011,40 - 44 años,"Neumonía, organismo no especificado",98,53,45
2011,40 - 44 años,"Disparo de otras armas de fuego, y las no especificadas",82,71,11
2011,40 - 44 años,"Envenenamiento accidental por, y exposición al alcohol",81,78,3
2011,40 - 44 años,Secuelas de otros efectos y los no especificados de causas externas,72,57,15
2011,40 - 44 años,Trastornos mentales y del comportamiento debidos al uso de alcohol,65,59,6
2011,40 - 44 años,Tumor maligno del estómago,59,28,31
2011,40 - 44 años,Diarrea y gastroenteritis de presunto origen infeccioso,50,34,16
2011,40 - 44 años,"Enfermedad por virus de la inmunodeficiencia humana [VIH], sin otra especificación",40,30,10
2011,40 - 44 años,Diabetes mellitus no insulinodependiente,36,23,13
2011,40 - 44 años,"Síntomas, signos y hallazgos anormales clínicos y de laboratorio, no clasificados en otra parte",128,74,54
2011,40 - 44 años,Otras causas,1074,590,484
2011,45 - 49 años,"Agresión con disparo de otras armas de fuego, y las no especificadas",195,166,29
2011,45 - 49 años,Exposición a factores no especificados,192,164,28
2011,45 - 49 años,"Diabetes mellitus, no especificada",186,68,118
2011,45 - 49 años,Fibrosis y cirrosis del hígado,165,137,28
2011,45 - 49 años,Infarto agudo del miocardio,149,84,65
2011,45 - 49 años,"Neumonía, organismo no especificado",119,78,41
2011,45 - 49 años,Enfermedad alcohólica del hígado,99,83,16
2011,45 - 49 años,Trastornos mentales y del comportamiento debidos al uso de alcohol,76,69,7
2011,45 - 49 años,"Envenenamiento accidental por, y exposición al alcohol",69,66,3
2011,45 - 49 años,"Disparo de otras armas de fuego, y las no especificadas",63,55,8
2011,45 - 49 años,Tumor maligno del estómago,59,32,27
2011,45 - 49 años,Diarrea y gastroenteritis de presunto origen infeccioso,53,22,31
2011,45 - 49 años,Insuficiencia renal crónica,53,32,21
2011,45 - 49 años,Tumor maligno del hígado y de las vías biliares intrahepáticas,49,19,30
2011,45 - 49 años,Diabetes mellitus no insulinodependiente,49,29,20
2011,45 - 49 años,"Síntomas, signos y hallazgos anormales clínicos y de laboratorio, no clasificados en otra parte",141,87,54
2011,45 - 49 años,Otras causas,1203,641,562
2011,50 - 54 años,"Diabetes mellitus, no especificada",316,138,178
2011,50 - 54 años,Infarto agudo del miocardio,204,120,84
2011,50 - 54 años,Exposición a factores no especificados,172,144,28
2011,50 - 54 años,Fibrosis y cirrosis del hígado,169,111,58
2011,50 - 54 años,"Neumonía, organismo no especificado",138,77,61
2011,50 - 54 años,"Agresión con disparo de otras armas de fuego, y las no especificadas",133,110,23
2011,50 - 54 años,Enfermedad alcohólica del hígado,114,97,17
2011,50 - 54 años,Tumor maligno del estómago,102,41,61
2011,50 - 54 años,Tumor maligno del hígado y de las vías biliares intrahepáticas,80,32,48
2011,50 - 54 años,Diabetes mellitus no insulinodependiente,77,38,39
2011,50 - 54 años,Trastornos mentales y del comportamiento debidos al uso de alcohol,65,61,4
2011,50 - 54 años,Insuficiencia renal crónica,62,29,33
2011,50 - 54 años,"Envenenamiento accidental por, y exposición al alcohol",61,58,3
2011,50 - 54 años,Diarrea y gastroenteritis de presunto origen infeccioso,55,25,30
2011,50 - 54 años,Secuelas de otros efectos y los no especificados de causas externas,54,41,13
2011,50 - 54 años,"Síntomas, signos y hallazgos anormales clínicos y de laboratorio, no clasificados en otra parte",173,98,75
2011,50 - 54 años,Otras causas,1425,708,717
2011,55 - 59 años,"Diabetes mellitus, no especificada",422,169,253
2011,55 - 59 años,Infarto agudo del miocardio,262,150,112
2011,55 - 59 años,Fibrosis y cirrosis del hígado,183,117,66
2011,55 - 59 años,"Neumonía, organismo no especificado",180,105,75
2011,55 - 59 años,Exposición a factores no especificados,159,127,32
2011,55 - 59 años,Tumor maligno del hígado y de las vías biliares intrahepáticas,112,45,67
2011,55 - 59 años,Diabetes mellitus no insulinodependiente,112,43,69
2011,55 - 59 años,Tumor maligno del estómago,111,52,59
2011,55 - 59 años,"Agresión con disparo de otras armas de fuego, y las no especificadas",89,77,12
2011,55 - 59 años,Insuficiencia renal crónica,80,38,42
2011,55 - 59 años,"Accidente vascular encefálico agudo, no especificado como hemorrágico o isquémico",78,34,44
2011,55 - 59 años,Insuficiencia cardíaca,69,31,38
2011,55 - 59 años,Diarrea y gastroenteritis de presunto origen infeccioso,68,32,36
2011,55 - 59 años,Enfermedad alcohólica del hígado,60,54,6
2011,55 - 59 años,"Desnutrición proteicocalórica, no especificada",52,22,30
2011,55 - 59 años,"Síntomas, signos y hallazgos anormales clínicos y de laboratorio, no clasificados en otra parte",170,80,90
2011,55 - 59 años,Otras causas,1579,823,756
2011,60 - 64 años,"Diabetes mellitus, no especificada",436,178,258
2011,60 - 64 años,Infarto agudo del miocardio,307,176,131
2011,60 - 64 años,"Neumonía, organismo no especificado",224,117,107
2011,60 - 64 años,Fibrosis y cirrosis del hígado,195,122,73
2011,60 - 64 años,Tumor maligno del estómago,163,79,84
2011,60 - 64 años,Diabetes mellitus no insulinodependiente,155,64,91
2011,60 - 64 años,Exposición a factores no especificados,134,98,36
2011,60 - 64 años,Tumor maligno del hígado y de las vías biliares intrahepáticas,132,56,76
2011,60 - 64 años,Insuficiencia renal crónica,112,63,49
2011,60 - 64 años,"Accidente vascular encefálico agudo, no especificado como hemorrágico o isquémico",87,51,36
2011,60 - 64 años,Diarrea y gastroenteritis de presunto origen infeccioso,86,46,40
2011,60 - 64 años,Insuficiencia cardíaca,69,36,33
2011,60 - 64 años,Otras enfermedades cerebrovasculares,66,23,43
2011,60 - 64 años,Insuficiencia renal no especificada,61,29,32
2011,60 - 64 años,Enfermedad alcohólica del hígado,60,56,4
2011,60 - 64 años,"Síntomas, signos y hallazgos anormales clínicos y de laboratorio, no clasificados en otra parte",215,109,106
2011,60 - 64 años,Otras causas,1594,854,740
2011,65 - 69 años,"Diabetes mellitus, no especificada",433,168,265
2011,65 - 69 años,Infarto agudo del miocardio,386,236,150
2011,65 - 69 años,"Neumonía, organismo no especificado",273,135,138
2011,65 - 69 años,Fibrosis y cirrosis del hígado,176,106,70
2011,65 - 69 años,Tumor maligno del estómago,159,75,84
2011,65 - 69 años,Diabetes mellitus no insulinodependiente,148,58,90
2011,65 - 69 años,Tumor maligno del hígado y de las vías biliares intrahepáticas,147,69,78
2011,65 - 69 años,"Accidente vascular encefálico agudo, no especificado como hemorrágico o isquémico",124,71,53
2011,65 - 69 años,Insuficiencia cardíaca,122,65,57
2011,65 - 69 años,Exposición a factores no especificados,97,69,28
2011,65 - 69 años,Diarrea y gastroenteritis de presunto origen infeccioso,93,46,47
2011,65 - 69 años,Insuficiencia renal crónica,91,56,35
2011,65 - 69 años,Otras enfermedades cerebrovasculares,71,29,42
2011,65 - 69 años,Insuficiencia renal no especificada,66,34,32
2011,65 - 69 años,"Desnutrición proteicocalórica, no especificada",58,32,26
2011,65 - 69 años,"Síntomas, signos y hallazgos anormales clínicos y de laboratorio, no clasificados en otra parte",234,112,122
2011,65 - 69 años,Otras causas,1572,838,734
2011,70 - 74 años,"Neumonía, organismo no especificado",442,217,225
2011,70 - 74 años,Infarto agudo del miocardio,435,217,218
2011,70 - 74 años,"Diabetes mellitus, no especificada",380,158,222
2011,70 - 74 años,Fibrosis y cirrosis del hígado,160,90,70
2011,70 - 74 años,"Accidente vascular encefálico agudo, no especificado como hemorrágico o isquémico",153,84,69
2011,70 - 74 años,Insuficiencia cardíaca,146,71,75
2011,70 - 74 años,Tumor maligno del estómago,145,69,76
2011,70 - 74 años,Tumor maligno del hígado y de las vías biliares intrahepáticas,145,68,77
2011,70 - 74 años,Diabetes mellitus no insulinodependiente,128,46,82
2011,70 - 74 años,Exposición a factores no especificados,100,67,33
2011,70 - 74 años,Diarrea y gastroenteritis de presunto origen infeccioso,99,45,54
2011,70 - 74 años,"Desnutrición proteicocalórica, no especificada",99,63,36
2011,70 - 74 años,Insuficiencia renal crónica,97,50,47
2011,70 - 74 años,Otras enfermedades cerebrovasculares,89,47,42
2011,70 - 74 años,Otras enfermedades pulmonares obstructivas crónicas,72,42,30
2011,70 - 74 años,"Síntomas, signos y hallazgos anormales clínicos y de laboratorio, no clasificados en otra parte",366,187,179
2011,70 - 74 años,Otras causas,1768,978,790
2011,75 - 79 años,Infarto agudo del miocardio,589,322,267
2011,75 - 79 años,"Neumonía, organismo no especificado",584,301,283
2011,75 - 79 años,"Diabetes mellitus, no especificada",408,155,253
2011,75 - 79 años,"Accidente vascular encefálico agudo, no especificado como hemorrágico o isquémico",246,114,132
2011,75 - 79 años,Insuficiencia cardíaca,235,124,111
2011,75 - 79 años,Tumor maligno del estómago,162,83,79
2011,75 - 79 años,"Desnutrición proteicocalórica, no especificada",155,74,81
2011,75 - 79 años,Tumor maligno del hígado y de las vías biliares intrahepáticas,149,73,76
2011,75 - 79 años,Diabetes mellitus no insulinodependiente,143,46,97
2011,75 - 79 años,Diarrea y gastroenteritis de presunto origen infeccioso,124,65,59
2011,75 - 79 años,Otras enfermedades cerebrovasculares,123,60,63
2011,75 - 79 años,Otras enfermedades pulmonares obstructivas crónicas,119,59,60
2011,75 - 79 años,Exposición a factores no especificados,113,73,40
2011,75 - 79 años,Fibrosis y cirrosis del hígado,100,53,47
2011,75 - 79 años,"Síntomas, signos y hallazgos anormales clínicos y de laboratorio, no clasificados en otra parte",489,262,227
2011,75 - 79 años,Otras causas,1853,963,890
2011,80 - 84 años,"Neumonía, organismo no especificado",748,389,359
2011,80 - 84 años,Infarto agudo del miocardio,719,369,350
2011,80 - 84 años,"Diabetes mellitus, no especificada",336,124,212
2011,83 - 84 años,Insuficiencia cardíaca,321,171,150
2011,80 - 84 años,"Accidente vascular encefálico agudo, no especificado como hemorrágico o isquémico",251,116,135
2011,80 - 84 años,"Desnutrición proteicocalórica, no especificada",193,103,90
2011,80 - 84 años,Tumor maligno del estómago,155,73,82
2011,80 - 84 años,Otras enfermedades pulmonares obstructivas crónicas,147,75,72
2011,80 - 84 años,Diarrea y gastroenteritis de presunto origen infeccioso,127,62,65
2011,80 - 84 años,Otras enfermedades cerebrovasculares,122,56,66
2011,80 - 84 años,Tumor maligno del hígado y de las vías biliares intrahepáticas,109,61,48
2011,80 - 84 años,Diabetes mellitus no insulinodependiente,106,45,61
2011,80 - 84 años,Fibrosis y cirrosis del hígado,102,60,42
2011,80 - 84 años,Exposición a factores no especificados,101,55,46
2011,80 - 84 años,"Síntomas, signos y hallazgos anormales clínicos y de laboratorio, no clasificados en otra parte",711,343,368
2011,80 - 84 años,Otras causas,1858,899,959
2011,85 y más,Infarto agudo del miocardio,118,566,614
2011,85 y más,"Neumonía, organismo no especificado",1172,601,571
2011,85 y más,Insuficiencia cardíaca,487,223,264
2011,85 y más,"Accidente vascular encefálico agudo, no especificado como hemorrágico o isquémico",390,187,203
2011,85 y más,"Desnutrición proteicocalórica, no especificada",374,180,194
2011,85 y más,"Diabetes mellitus, no especificada",314,111,203
2011,85 y más,Otras enfermedades pulmonares obstructivas crónicas,189,85,104
2011,85 y más,Otras enfermedades cerebrovasculares,180,77,103
2011,85 y más,Exposición a factores no especificados,166,85,81
2011,85 y más,Tumor maligno del estómago,141,56,85
2011,85 y más,Diarrea y gastroenteritis de presunto origen infeccioso,133,68,65
2011,85 y más,Hipertensión esencial (primaria),130,51,79
2011,85 y más,Insuficiencia renal crónica,107,53,54
2011,85 y más,Insuficiencia renal no especificada,101,55,46
2011,85 y más,"Síntomas, signos y hallazgos anormales clínicos y de laboratorio, no clasificados en otra parte",1312,577,735
2011,85 y más,Otras causas,2059,921,1138
2012,1- 6 días,Dificultad respiratoria del recién nacido,289,171,118
2012,1- 6 días,Síndromes de aspiración neonatal,196,102,94
2012,1- 6 días,"Otras malformaciones congénitas, no clasificadas en otra parte",117,67,50
2012,1- 6 días,"Trastornos relacionados con duración corta de la gestación y con bajo peso al nacer, no clasificados en otra parte",114,68,46
2012,1- 6 días,Sepsis bacteriana del recién nacido,110,60,50
2012,1- 6 días,Neumonía congénita,98,61,37
2012,1- 6 días,Asfixia del nacimiento,94,57,37
2012,1- 6 días,Otras malformaciones congénitas del corazón,52,34,18
2012,1- 6 días,Trastornos cardiovasculares originados en el período perinatal,40,18,22
2012,1- 6 días,Otras afecciones originadas en el período perinatal,27,19,8
2012,1- 6 días,"Malformaciones congénitas del sistema osteomuscular, no clasificadas en otra parte",23,18,5
2012,1- 6 días,Anencefalia y malformaciones congénitas similares,18,10,8
2012,1- 6 días,Coagulación intravascular diseminada en el feto y el recién nacido,16,6,10
2012,1- 6 días,Hemorragia intracraneal no traumática del feto y del recién nacido,13,6,7
2012,1- 6 días,"Otros problemas respiratorios del recién nacido, originados en el período perinatal",12,8,4
2012,1- 6 días,"Síntomas, signos y hallazgos anormales clínicos y de laboratorio, no clasificados en otra parte",47,28,19
2012,1- 6 días,Otras causas,215,114,101
2012,7 - 27 días,Sepsis bacteriana del recién nacido,201,103,98
2012,7 - 27 días,Dificultad respiratoria del recién nacido,192,106,86
2012,7 - 27 días,Neumonía congénita,187,101,86
2012,7 - 27 días,Síndromes de aspiración neonatal,106,54,52
2012,7 - 27 días,Asfixia del nacimiento,72,40,32
2012,7 - 27 días,Otras malformaciones congénitas del corazón,64,27,37
2012,7 - 27 días,"Trastornos relacionados con duración corta de la gestación y con bajo peso al nacer, no clasificados en otra parte",57,36,21
2012,7 - 27 días,"Otras malformaciones congénitas, no clasificadas en otra parte",57,35,22
2012,7 - 27 días,Enterocolitis necrotizante del feto y del recién nacido,54,33,21
2012,7 - 27 días,Coagulación intravascular diseminada en el feto y el recién nacido,38,22,16
2012,7 - 27 días,Trastornos cardiovasculares originados en el período perinatal,26,20,6
2012,7 - 27 días,Otras afecciones originadas en el período perinatal,26,11,15
2012,7 - 27 días,Hemorragia intracraneal no traumática del feto y del recién nacido,23,12,11
2012,7 - 27 días,"Malformaciones congénitas del sistema osteomuscular, no clasificadas en otra parte",23,11,12
2012,7 - 27 días,"Neumonía, organismo no especificado",21,9,12
2012,7 - 27 días,"Síntomas, signos y hallazgos anormales clínicos y de laboratorio, no clasificados en otra parte",58,36,22
2012,7 - 27 días,Otras causas,330,176,154
2012,28 días a menos de 1 año,"Neumonía, organismo no especificado",1318,742,576
2012,28 días a menos de 1 año,Diarrea y gastroenteritis de presunto origen infeccioso,430,246,184
2012,28 días a menos de 1 año,Otras septicemias,170,100,70
2012,28 días a menos de 1 año,Otras malformaciones congénitas del corazón,167,90,77
2012,28 días a menos de 1 año,"Desnutrición proteicocalórica, no especificada",98,49,49
2012,28 días a menos de 1 año,Sepsis bacteriana del recién nacido,75,45,30
2012,28 días a menos de 1 año,"Otras malformaciones congénitas, no clasificadas en otra parte",65,36,29
2012,28 días a menos de 1 año,Neumonía congénita,53,30,23
2012,28 días a menos de 1 año,Obstrucción no especificada de la respiración,53,27,26
2012,28 días a menos de 1 año,Dificultad respiratoria del recién nacido,45,29,16
2012,28 días a menos de 1 año,Insuficiencia cardíaca,38,21,17
2012,28 días a menos de 1 año,"Trastornos relacionados con duración corta de la gestación y con bajo peso al nacer, no clasificados en otra parte",37,21,16
2012,28 días a menos de 1 año,Síndromes de aspiración neonatal,36,20,16
2012,28 días a menos de 1 año,"Neumonía bacteriana, no clasificada en otra parte",34,19,15
2012,28 días a menos de 1 año,"Desnutrición proteicocalórica severa, no especificada",32,13,19
2012,28 días a menos de 1 año,"Síntomas, signos y hallazgos anormales clínicos y de laboratorio, no clasificados en otra parte",282,153,129
2012,28 días a menos de 1 año,Otras causas,1043,559,484
2012,1 año,"Neumonía, organismo no especificado",429,221,208
2012,1 año,Diarrea y gastroenteritis de presunto origen infeccioso,362,185,177
2012,1 año,"Desnutrición proteicocalórica, no especificada",58,28,30
2012,1 año,Otras septicemias,37,14,23
2012,1 año,Otras malformaciones congénitas del corazón,26,13,13
2012,1 año,Exposición a factores no especificados,26,17,9
2012,1 año,"Desnutrición proteicocalórica severa, no especificada",20,11,9
2012,1 año,Depleción del volumen,17,8,9
2012,1 año,"Otros trastornos de los líquidos, de los electrólitos y del equilibrio ácido-básico",15,8,7
2012,1 año,"Neumonía bacteriana, no clasificada en otra parte",14,6,8
2012,1 año,Ahogamiento y sumersión no especificados,14,9,5
2012,1 año,"Parasitosis intestinal, sin otra especificación",12,5,7
2012,1 año,Epilepsia,12,6,6
2012,1 año,Hidrocéfalo,12,7,5
2012,1 año,Obstrucción no especificada de la respiración,11,6,5
2012,1 año,"Síntomas, signos y hallazgos anormales clínicos y de laboratorio, no clasificados en otra parte",106,49,57
2012,1 año,Otras causas,266,136,130
2012,2 años,"Neumonía, organismo no especificado",135,61,74
2012,2 años,Diarrea y gastroenteritis de presunto origen infeccioso,116,62,54
2012,2 años,"Desnutrición proteicocalórica, no especificada",19,7,12
2012,2 años,Otras septicemias,17,11,6
2012,2 años,Exposición a factores no especificados,15,9,6
2012,2 años,"Desnutrición proteicocalórica severa, no especificada",9,4,5
2012,2 años,"Exposición a humos, fuegos o llamas no especificados",9,5,4
2012,2 años,"Otros trastornos de los líquidos, de los electrólitos y del equilibrio ácido-básico",8,6,2
2012,2 años,Depleción del volumen,7,3,4
2012,2 años,Ileo paralítico y obstrucción intestinal sin hernia,6,3,3
2012,2 años,Otras malformaciones congénitas del corazón,6,4,2
2012,2 años,Obstrucción no especificada de la respiración,6,1,5
2012,2 años,Ascariasis,5,1,4
2012,2 años,"Parasitosis intestinal, sin otra especificación",5,2,3
2012,2 años,"Neumonía bacteriana, no clasificada en otra parte",5,1,4
2012,2 años,"Síntomas, signos y hallazgos anormales clínicos y de laboratorio, no clasificados en otra parte",37,22,15
2012,2 años,Otras causas,135,74,61
2012,3 años,"Neumonía, organismo no especificado",60,38,22
2012,3 años,Diarrea y gastroenteritis de presunto origen infeccioso,46,23,23
2012,3 años,Exposición a factores no especificados,21,11,10
2012,3 años,Otras septicemias,11,7,4
2012,3 años,"Desnutrición proteicocalórica, no especificada",9,3,6
2012,3 años,Ileo paralítico y obstrucción intestinal sin hernia,7,5,2
2012,3 años,Epilepsia,6,3,3
2012,3 años,"Otros trastornos de los líquidos, de los electrólitos y del equilibrio ácido-básico",5,2,3
2012,3 años,Ahogamiento y sumersión no especificados,5,3,2
2012,3 años,Varicela,4,2,2
2012,3 años,Tumor maligno del ojo y sus anexos,4,2,2
2012,3 años,"Neumonía bacteriana, no clasificada en otra parte",4,1,3
2012,3 años,Asma,4,3,1
2012,3 años,Síndrome de Down,4,2,2
2012,3 años,"Síntomas, signos y hallazgos anormales clínicos y de laboratorio, no clasificados en otra parte",20,9,11
2012,3 años,Otras causas,80,52,28
2012,4 años,Diarrea y gastroenteritis de presunto origen infeccioso,37,18,19
2012,4 años,"Neumonía, organismo no especificado",34,15,19
2012,4 años,Exposición a factores no especificados,10,4,6
2012,4 años,"Desnutrición proteicocalórica, no especificada",8,6,2
2012,4 años,Epilepsia,7,6,1
2012,4 años,Secuelas de otros efectos y los no especificados de causas externas,5,2,3
2012,4 años,Leucemia linfoide,4,1,3
2012,4 años,Leucemia de células de tipo no especificado,4,1,3
2012,4 años,"Otros trastornos de los líquidos, de los electrólitos y del equilibrio ácido-básico",4,3,1
2012,4 años,Ahogamiento y sumersión no especificados,4,3,1
2012,4 años,Otras septicemias,3,2,1
2012,4 años,"Parasitosis intestinal, sin otra especificación",3,2,1
2012,4 años,Tumor maligno del ojo y sus anexos,3,2,1
2012,4 años,"Síntomas, signos y hallazgos anormales clínicos y de laboratorio, no clasificados en otra parte",8,4,4
2012,4 años,Otras causas,68,37,31
2012,5 - 9 años,"Neumonía, organismo no especificado",117,59,58
2012,5 - 9 años,Diarrea y gastroenteritis de presunto origen infeccioso,79,48,31
2012,5 - 9 años,Exposición a factores no especificados,61,44,17
2012,5 - 9 años,Secuelas de otros efectos y los no especificados de causas externas,29,16,13
2012,5 - 9 años,Ahogamiento y sumersión no especificados,22,15,7
2012,5 - 9 años,Epilepsia,16,9,7
2012,5 - 9 años,Otras septicemias,14,8,6
2012,5 - 9 años,Leucemia linfoide,12,6,6
2012,5 - 9 años,Tumor maligno del encéfalo,11,8,3
2012,5 - 9 años,"Desnutrición proteicocalórica severa, no especificada",10,3,7
2012,5 - 9 años,Ileo paralítico y obstrucción intestinal sin hernia,10,8,2
2012,5 - 9 años,Insuficiencia renal no especificada,10,4,6
2012,5 - 9 años,Leucemia de células de tipo no especificado,9,4,5
2012,5 - 9 años,Parálisis cerebral,9,6,3
2012,5 - 9 años,Insuficiencia renal crónica,9,3,6
2012,5 - 9 años,"Síntomas, signos y hallazgos anormales clínicos y de laboratorio, no clasificados en otra parte",49,24,25
2012,5 - 9 años,Otras causas,255,120,135
2012,10 - 14 años,"Neumonía, organismo no especificado",70,45,25
2012,10 - 14 años,Exposición a factores no especificados,64,45,19
2012,10 - 14 años,"Agresión con disparo de otras armas de fuego, y las no especificadas",58,47,11
2012,10 - 14 años,Diarrea y gastroenteritis de presunto origen infeccioso,39,21,18
2012,10 - 14 años,Secuelas de otros efectos y los no especificados de causas externas,37,28,9
2012,10 - 14 años,"Disparo de otras armas de fuego, y las no especificadas",26,20,6
2012,10 - 14 años,Ahogamiento y sumersión no especificados,22,15,7
2012,10 - 14 años,Otros estrangulamientos y ahorcamientos accidentales,21,9,12
2012,10 - 14 años,Epilepsia,20,8,12
2012,10 - 14 años,"Desnutrición proteicocalórica, no especificada",18,6,12
2012,10 - 14 años,"Lesión autoinfligida intencionalmente por ahorcamiento, estrangulamiento o sofocación",17,11,6
2012,10 - 14 años,Leucemia linfoide,14,10,4
2012,10 - 14 años,Leucemia de células de tipo no especificado,14,7,7
2012,10 - 14 años,Insuficiencia renal crónica,14,6,8
2012,10 - 14 años,Otras septicemias,11,7,4
2012,10 - 14 años,"Síntomas, signos y hallazgos anormales clínicos y de laboratorio, no clasificados en otra parte",50,26,24
2012,10 - 14 años,Otras causas,349,185,164
2012,15 - 19 años,"Agresión con disparo de otras armas de fuego, y las no especificadas",446,392,54
2012,15 - 19 años,Exposición a factores no especificados,196,167,29
2012,15 - 19 años,"Disparo de otras armas de fuego, y las no especificadas",191,166,25
2012,15 - 19 años,Secuelas de otros efectos y los no especificados de causas externas,89,77,12
2012,15 - 19 años,"Neumonía, organismo no especificado",57,32,25
2012,15 - 19 años,Diarrea y gastroenteritis de presunto origen infeccioso,50,31,19
2012,15 - 19 años,"Envenenamiento accidental por, y exposición a otros productos químicos y sustancias nocivas, y los no especificados",49,22,27
2012,15 - 19 años,Otros estrangulamientos y ahorcamientos accidentales,47,35,12
2012,15 - 19 años,Ahogamiento y sumersión no especificados,45,43,2
2012,15 - 19 años,"Lesión autoinfligida intencionalmente por ahorcamiento, estrangulamiento o sofocación",43,24,19
2012,15 - 19 años,"Envenenamiento accidental por, y exposición a plaguicidas",30,11,19
2012,15 - 19 años,Infarto agudo del miocardio,27,13,14
2012,15 - 19 años,"Envenenamiento autoinfligido intencionalmente por, y exposición a plaguicidas",27,17,10
2012,15 - 19 años,Insuficiencia renal crónica,25,11,14
2012,15 - 19 años,Epilepsia,24,10,14
2012,15 - 19 años,"Síntomas, signos y hallazgos anormales clínicos y de laboratorio, no clasificados en otra parte",105,56,49
2012,15 - 19 años,Otras causas,668,364,304
2012,20 - 24 años,"Agresión con disparo de otras armas de fuego, y las no especificadas",581,525,56
2012,20 - 24 años,Exposición a factores no especificados,289,255,34
2012,20 - 24 años,"Disparo de otras armas de fuego, y las no especificadas",253,228,25
2012,20 - 24 años,Secuelas de otros efectos y los no especificados de causas externas,136,123,13
2012,20 - 24 años,"Neumonía, organismo no especificado",79,43,36
2012,20 - 24 años,Otros estrangulamientos y ahorcamientos accidentales,59,52,7
2012,20 - 24 años,Agresión con objeto cortante,58,50,8
2012,20 - 24 años,Ahogamiento y sumersión no especificados,47,45,2
2012,20 - 24 años,"Envenenamiento accidental por, y exposición a otros productos químicos y sustancias nocivas, y los no especificados",47,27,20
2012,20 - 24 años,Infarto agudo del miocardio,37,23,14
2012,20 - 24 años,Diarrea y gastroenteritis de presunto origen infeccioso,33,7,26
2012,20 - 24 años,Epilepsia,32,20,12
2012,20 - 24 años,"Envenenamiento accidental por, y exposición a plaguicidas",32,21,11
2012,20 - 24 años,Obstrucción no especificada de la respiración,31,23,8
2012,20 - 24 años,"Envenenamiento accidental por, y exposición al alcohol",30,29,1
2012,20 - 24 años,"Síntomas, signos y hallazgos anormales clínicos y de laboratorio, no clasificados en otra parte",106,62,44
2012,20 - 24 años,Otras causas,850,464,386
2012,25 - 29 años,"Agresión con disparo de otras armas de fuego, y las no especificadas",526,487,39
2012,25 - 29 años,Exposición a factores no especificados,255,224,31
2012,25 - 29 años,"Disparo de otras armas de fuego, y las no especificadas",218,203,15
2012,25 - 29 años,"Neumonía, organismo no especificado",108,76,32
2012,25 - 29 años,Secuelas de otros efectos y los no especificados de causas externas,103,91,12
2012,25 - 29 años,Infarto agudo del miocardio,60,27,33
2012,25 - 29 años,Fibrosis y cirrosis del hígado,58,47,11
2012,25 - 29 años,"Envenenamiento accidental por, y exposición al alcohol",56,51,5
2012,25 - 29 años,Enfermedad alcohólica del hígado,49,44,5
2012,25 - 29 años,Otros estrangulamientos y ahorcamientos accidentales,45,34,11
2012,25 - 29 años,"Envenenamiento accidental por, y exposición a otros productos químicos y sustancias nocivas, y los no especificados",44,34,10
2012,25 - 29 años,Diarrea y gastroenteritis de presunto origen infeccioso,42,25,17
2012,25 - 29 años,Agresión con objeto cortante,37,31,6
2012,25 - 29 años,"Enfermedad por virus de la inmunodeficiencia humana [VIH], resultante en enfermedades infecciosas y parasitarias",34,17,17
2012,25 - 29 años,"Enfermedad por virus de la inmunodeficiencia humana [VIH], sin otra especificación",33,23,10
2012,25 - 29 años,"Síntomas, signos y hallazgos anormales clínicos y de laboratorio, no clasificados en otra parte",97,58,39
2012,25 - 29 años,Otras causas,923,495,428
2012,30 - 34 años,"Agresión con disparo de otras armas de fuego, y las no especificadas",396,357,39
2012,30 - 34 años,Exposición a factores no especificados,282,249,33
2012,30 - 34 años,"Disparo de otras armas de fuego, y las no especificadas",186,169,17
2012,30 - 34 años,Secuelas de otros efectos y los no especificados de causas externas,109,97,12
2012,30 - 34 años,Fibrosis y cirrosis del hígado,90,78,12
2012,30 - 34 años,"Neumonía, organismo no especificado",88,59,29
2012,30 - 34 años,Infarto agudo del miocardio,69,51,18
2012,30 - 34 años,"Envenenamiento accidental por, y exposición al alcohol",69,61,8
2012,30 - 34 años,"Diabetes mellitus, no especificada",48,26,22
2012,30 - 34 años,Enfermedad alcohólica del hígado,48,41,7
2012,30 - 34 años,Agresión con objeto cortante,47,40,7
2012,30 - 34 años,"Enfermedad por virus de la inmunodeficiencia humana [VIH], sin otra especificación",45,29,16
2012,30 - 34 años,Trastornos mentales y del comportamiento debidos al uso de alcohol,41,37,4
2012,30 - 34 años,"Enfermedad por virus de la inmunodeficiencia humana [VIH], resultante en enfermedades infecciosas y parasitarias",36,23,13
2012,30 - 34 años,Diarrea y gastroenteritis de presunto origen infeccioso,35,20,15
2012,30 - 34 años,"Síntomas, signos y hallazgos anormales clínicos y de laboratorio, no clasificados en otra parte",110,70,40
2012,30 - 34 años,Otras causas,1038,564,474
2012,35 - 39 años,"Agresión con disparo de otras armas de fuego, y las no especificadas",369,339,30
2012,35 - 39 años,Exposición a factores no especificados,203,173,30
2012,35 - 39 años,"Disparo de otras armas de fuego, y las no especificadas",131,116,15
2012,35 - 39 años,Fibrosis y cirrosis del hígado,112,93,19
2012,35 - 39 años,"Envenenamiento accidental por, y exposición al alcohol",96,90,6
2012,35 - 39 años,Infarto agudo del miocardio,91,55,36
2012,35 - 39 años,"Neumonía, organismo no especificado",91,65,26
2012,35 - 39 años,Enfermedad alcohólica del hígado,85,75,10
2012,35 - 39 años,Secuelas de otros efectos y los no especificados de causas externas,84,68,16
2012,35 - 39 años,"Diabetes mellitus, no especificada",80,40,40
2012,35 - 39 años,Trastornos mentales y del comportamiento debidos al uso de alcohol,45,39,6
2012,35 - 39 años,"Enfermedad por virus de la inmunodeficiencia humana [VIH], resultante en enfermedades infecciosas y parasitarias",43,29,14
2012,35 - 39 años,"Enfermedad por virus de la inmunodeficiencia humana [VIH], sin otra especificación",39,26,13
2012,35 - 39 años,Tumor maligno del estómago,39,11,28
2012,35 - 39 años,Diarrea y gastroenteritis de presunto origen infeccioso,34,17,17
2012,35 - 39 años,"Síntomas, signos y hallazgos anormales clínicos y de laboratorio, no clasificados en otra parte",113,70,43
2012,35 - 39 años,Otras causas,1069,586,483
2012,40 - 44 años,"Agresión con disparo de otras armas de fuego, y las no especificadas",258,235,23
2012,40 - 44 años,Exposición a factores no especificados,197,169,28
2012,40 - 44 años,Fibrosis y cirrosis del hígado,137,107,30
2012,40 - 44 años,Infarto agudo del miocardio,124,80,44
2012,40 - 44 años,"Diabetes mellitus, no especificada",123,63,60
2012,40 - 44 años,Enfermedad alcohólica del hígado,95,79,16
2012,40 - 44 años,"Neumonía, organismo no especificado",91,62,29
2012,40 - 44 años,"Disparo de otras armas de fuego, y las no especificadas",91,78,13
2012,40 - 44 años,"Envenenamiento accidental por, y exposición al alcohol",91,86,5
2012,40 - 44 años,Secuelas de otros efectos y los no especificados de causas externas,56,43,13
2012,40 - 44 años,Trastornos mentales y del comportamiento debidos al uso de alcohol,54,49,5
2012,40 - 44 años,Insuficiencia renal crónica,49,25,24
2012,40 - 44 años,Tumor maligno del estómago,45,20,25
2012,40 - 44 años,Diarrea y gastroenteritis de presunto origen infeccioso,39,22,17
2012,40 - 44 años,"Síntomas, signos y hallazgos anormales clínicos y de laboratorio, no clasificados en otra parte",108,69,39
2012,40 - 44 años,Otras causas,1086,603,483
2012,45 - 49 años,"Diabetes mellitus, no especificada",174,85,89
2012,45 - 49 años,Exposición a factores no especificados,168,147,21
2012,45 - 49 años,"Agresión con disparo de otras armas de fuego, y las no especificadas",165,148,17
2012,45 - 49 años,Infarto agudo del miocardio,156,97,59
2012,45 - 49 años,Fibrosis y cirrosis del hígado,154,120,34
2012,45 - 49 años,"Neumonía, organismo no especificado",117,72,45
2012,45 - 49 años,Enfermedad alcohólica del hígado,85,71,14
2012,45 - 49 años,"Envenenamiento accidental por, y exposición al alcohol",78,74,4
2012,45 - 49 años,Tumor maligno del estómago,70,27,43
2012,45 - 49 años,Diabetes mellitus no insulinodependiente,68,31,37
2012,45 - 49 años,Tumor maligno del hígado y de las vías biliares intrahepáticas,67,31,36
2012,45 - 49 años,Secuelas de otros efectos y los no especificados de causas externas,66,52,14
2012,45 - 49 años,"Disparo de otras armas de fuego, y las no especificadas",66,56,10
2012,45 - 49 años,Insuficiencia renal crónica,62,26,36
2012,45 - 49 años,Trastornos mentales y del comportamiento debidos al uso de alcohol,47,46,1
2012,45 - 49 años,"Síntomas, signos y hallazgos anormales clínicos y de laboratorio, no clasificados en otra parte",139,79,60
2012,45 - 49 años,Otras causas,1134,562,572
2012,50 - 54 años,"Diabetes mellitus, no especificada",314,141,173
2012,50 - 54 años,Infarto agudo del miocardio,219,131,88
2012,50 - 54 años,Fibrosis y cirrosis del hígado,216,150,66
2012,50 - 54 años,"Neumonía, organismo no especificado",158,80,78
2012,50 - 54 años,Exposición a factores no especificados,156,132,24
2012,50 - 54 años,"Agresión con disparo de otras armas de fuego, y las no especificadas",135,117,18
2012,50 - 54 años,Diabetes mellitus no insulinodependiente,112,43,69
2012,50 - 54 años,Enfermedad alcohólica del hígado,111,96,15
2012,50 - 54 años,Tumor maligno del estómago,81,30,51
2012,50 - 54 años,Insuficiencia renal crónica,81,38,43
2012,50 - 54 años,Tumor maligno del hígado y de las vías biliares intrahepáticas,77,36,41
2012,50 - 54 años,"Envenenamiento accidental por, y exposición al alcohol",67,63,4
2012,50 - 54 años,Diarrea y gastroenteritis de presunto origen infeccioso,59,24,35
2012,50 - 54 años,Secuelas de otros efectos y los no especificados de causas externas,55,41,14
2012,50 - 54 años,"Síntomas, signos y hallazgos anormales clínicos y de laboratorio, no clasificados en otra parte",151,88,63
2012,50 - 54 años,Otras causas,1351,737,614
2012,55 - 59 años,"Diabetes mellitus, no especificada",416,178,238
2012,55 - 59 años,Infarto agudo del miocardio,243,148,95
2012,55 - 59 años,Fibrosis y cirrosis del hígado,238,147,91
2012,55 - 59 años,"Neumonía, organismo no especificado",198,100,98
2012,55 - 59 años,Exposición a factores no especificados,151,130,21
2012,55 - 59 años,Diabetes mellitus no insulinodependiente,129,53,76
2012,55 - 59 años,Tumor maligno del estómago,124,55,69
2012,55 - 59 años,Tumor maligno del hígado y de las vías biliares intrahepáticas,119,52,67
2012,55 - 59 años,Insuficiencia renal crónica,109,55,54
2012,55 - 59 años,"Accidente vascular encefálico agudo, no especificado como hemorrágico o isquémico",84,36,48
2012,55 - 59 años,Enfermedad alcohólica del hígado,84,65,19
2012,55 - 59 años,"Agresión con disparo de otras armas de fuego, y las no especificadas",77,68,9
2012,55 - 59 años,Diarrea y gastroenteritis de presunto origen infeccioso,62,29,33
2012,55 - 59 años,Insuficiencia cardíaca,53,20,33
2012,55 - 59 años,"Síntomas, signos y hallazgos anormales clínicos y de laboratorio, no clasificados en otra parte",164,83,81
2012,55 - 59 años,Otras causas,1509,791,718
2012,60 - 64 años,"Diabetes mellitus, no especificada",460,192,268
2012,60 - 64 años,Infarto agudo del miocardio,338,186,152
2012,60 - 64 años,"Neumonía, organismo no especificado",227,118,109
2012,60 - 64 años,Fibrosis y cirrosis del hígado,225,134,91
2012,60 - 64 años,Diabetes mellitus no insulinodependiente,164,71,93
2012,60 - 64 años,Tumor maligno del hígado y de las vías biliares intrahepáticas,159,79,80
2012,60 - 64 años,Exposición a factores no especificados,143,119,24
2012,60 - 64 años,Tumor maligno del estómago,132,62,70
2012,60 - 64 años,Insuficiencia renal crónica,123,53,70
2012,60 - 64 años,"Accidente vascular encefálico agudo, no especificado como hemorrágico o isquémico",103,43,60
2012,60 - 64 años,Insuficiencia cardíaca,82,32,50
2012,60 - 64 años,Diarrea y gastroenteritis de presunto origen infeccioso,81,42,39
2012,60 - 64 años,Otras enfermedades cerebrovasculares,71,33,38
2012,60 - 64 años,Enfermedad alcohólica del hígado,61,50,11
2012,60 - 64 años,Insuficiencia renal no especificada,60,38,22
2012,60 - 64 años,"Síntomas, signos y hallazgos anormales clínicos y de laboratorio, no clasificados en otra parte",240,140,100
2012,60 - 64 años,Otras causas,1664,905,759
2012,65 - 69 años,"Diabetes mellitus, no especificada",476,193,283
2012,65 - 69 años,Infarto agudo del miocardio,394,222,172
2012,65 - 69 años,"Neumonía, organismo no especificado",290,157,133
2012,65 - 69 años,Fibrosis y cirrosis del hígado,194,111,83
2012,65 - 69 años,Tumor maligno del hígado y de las vías biliares intrahepáticas,169,71,98
2012,65 - 69 años,Diabetes mellitus no insulinodependiente,168,65,103
2012,65 - 69 años,Tumor maligno del estómago,142,80,62
2012,65 - 69 años,"Accidente vascular encefálico agudo, no especificado como hemorrágico o isquémico",120,50,70
2012,65 - 69 años,Exposición a factores no especificados,111,85,26
2012,65 - 69 años,Insuficiencia cardíaca,108,61,47
2012,65 - 69 años,Insuficiencia renal crónica,101,54,47
2012,65 - 69 años,Diarrea y gastroenteritis de presunto origen infeccioso,93,49,44
2012,65 - 69 años,Insuficiencia renal no especificada,79,33,46
2012,65 - 69 años,"Desnutrición proteicocalórica, no especificada",77,43,34
2012,65 - 69 años,Otras enfermedades cerebrovasculares,72,35,37
2012,65 - 69 años,"Síntomas, signos y hallazgos anormales clínicos y de laboratorio, no clasificados en otra parte",310,160,150
2012,65 - 69 años,Otras causas,168,935,745
2012,70 - 74 años,Infarto agudo del miocardio,493,285,208
2012,70 - 74 años,"Diabetes mellitus, no especificada",428,151,277
2012,70 - 74 años,"Neumonía, organismo no especificado",416,221,195
2012,70 - 74 años,"Accidente vascular encefálico agudo, no especificado como hemorrágico o isquémico",189,88,101
2012,70 - 74 años,Tumor maligno del hígado y de las vías biliares intrahepáticas,174,87,87
2012,70 - 74 años,Diabetes mellitus no insulinodependiente,161,75,86
2012,70 - 74 años,Insuficiencia cardíaca,160,74,86
2012,70 - 74 años,Tumor maligno del estómago,155,71,84
2012,70 - 74 años,Fibrosis y cirrosis del hígado,154,79,75
2012,70 - 74 años,Exposición a factores no especificados,147,99,48
2012,70 - 74 años,Insuficiencia renal crónica,128,76,52
2012,70 - 74 años,"Desnutrición proteicocalórica, no especificada",117,59,58
2012,70 - 74 años,Diarrea y gastroenteritis de presunto origen infeccioso,95,52,43
2012,70 - 74 años,Insuficiencia renal no especificada,94,47,47
2012,70 - 74 años,Otras enfermedades cerebrovasculares,89,50,39
2012,70 - 74 años,"Síntomas, signos y hallazgos anormales clínicos y de laboratorio, no clasificados en otra parte",342,171,171
2012,70 - 74 años,Otras causas,1737,990,747
2012,75 - 79 años,Infarto agudo del miocardio,599,338,261
2012,75 - 79 años,"Neumonía, organismo no especificado",551,289,262
2012,75 - 79 años,"Diabetes mellitus, no especificada",414,163,251
2012,75 - 79 años,"Accidente vascular encefálico agudo, no especificado como hemorrágico o isquémico",245,121,124
2012,75 - 79 años,Insuficiencia cardíaca,210,100,110
2012,75 - 79 años,Tumor maligno del estómago,192,99,93
2012,75 - 79 años,Tumor maligno del hígado y de las vías biliares intrahepáticas,140,57,83
2012,75 - 79 años,"Desnutrición proteicocalórica, no especificada",134,63,71
2012,75 - 79 años,Fibrosis y cirrosis del hígado,126,75,51
2012,75 - 79 años,Diabetes mellitus no insulinodependiente,123,42,81
2012,75 - 79 años,Insuficiencia renal crónica,122,70,52
2012,75 - 79 años,Otras enfermedades cerebrovasculares,118,69,49
2012,75 - 79 años,Insuficiencia renal no especificada,113,61,52
2012,75 - 79 años,Otras enfermedades pulmonares obstructivas crónicas,111,57,54
2012,75 - 79 años,Diarrea y gastroenteritis de presunto origen infeccioso,108,55,53
2012,75 - 79 años,"Síntomas, signos y hallazgos anormales clínicos y de laboratorio, no clasificados en otra parte",485,247,238
2012,75 - 79 años,Otras causas,185,993,857
2012,80 - 84 años,Infarto agudo del miocardio,778,410,368
2012,80 - 84 años,"Neumonía, organismo no especificado",715,353,362
2012,80 - 84 años,"Diabetes mellitus, no especificada",356,140,216
2012,80 - 84 años,"Accidente vascular encefálico agudo, no especificado como hemorrágico o isquémico",288,135,153
2012,80 - 84 años,Insuficiencia cardíaca,287,150,137
2012,80 - 84 años,"Desnutrición proteicocalórica, no especificada",212,109,103
2012,80 - 84 años,Tumor maligno del estómago,181,80,101
2012,80 - 84 años,Insuficiencia renal crónica,140,77,63
2012,80 - 84 años,Diabetes mellitus no insulinodependiente,134,46,88
2012,80 - 84 años,Exposición a factores no especificados,129,78,51
2012,80 - 84 años,Tumor maligno del hígado y de las vías biliares intrahepáticas,128,55,73
2012,80 - 84 años,Otras enfermedades cerebrovasculares,118,53,65
2012,80 - 84 años,Otras enfermedades pulmonares obstructivas crónicas,117,53,64
2012,80 - 84 años,Diarrea y gastroenteritis de presunto origen infeccioso,116,55,61
2012,80 - 84 años,"Síntomas, signos y hallazgos anormales clínicos y de laboratorio, no clasificados en otra parte",703,345,358
2012,80 - 84 años,Otras causas,1846,922,924
2012,85 y más,Infarto agudo del miocardio,1276,598,678
2012,85 y más,"Neumonía, organismo no especificado",1208,583,625
2012,85 y más,Insuficiencia cardíaca,538,255,283
2012,85 y más,"Accidente vascular encefálico agudo, no especificado como hemorrágico o isquémico",457,199,258
2012,85 y más,"Desnutrición proteicocalórica, no especificada",410,149,261
2012,85 y más,"Diabetes mellitus, no especificada",295,117,178
2012,85 y más,Otras enfermedades pulmonares obstructivas crónicas,229,125,104
2012,85 y más,Otras enfermedades cerebrovasculares,176,80,96
2012,85 y más,Tumor maligno del estómago,162,68,94
2012,85 y más,Exposición a factores no especificados,159,71,88
2012,85 y más,Diarrea y gastroenteritis de presunto origen infeccioso,127,62,65
2012,85 y más,Insuficiencia renal crónica,116,68,48
2012,85 y más,Insuficiencia renal no especificada,116,59,57
2012,85 y más,Hipertensión esencial (primaria),115,55,60
2012,85 y más,"Síntomas, signos y hallazgos anormales clínicos y de laboratorio, no clasificados en otra parte",1252,560,692
2012,85 y más,Otras causas,2142,973,1169
2013,1- 6 días,Dificultad respiratoria del recién nacido,304,181,123
2013,1- 6 días,Síndromes de aspiración neonatal,189,99,90
2013,1- 6 días,Sepsis bacteriana del recién nacido,111,71,40
2013,1- 6 días,"Otras malformaciones congénitas, no clasificadas en otra parte",109,63,46
2013,1- 6 días,Neumonía congénita,95,60,35
2013,1- 6 días,"Trastornos relacionados con duración corta de la gestación y con bajo peso al nacer, no clasificados en otra parte",65,42,23
2013,1- 6 días,Asfixia del nacimiento,64,40,24
2013,1- 6 días,Trastornos cardiovasculares originados en el período perinatal,63,43,20
2013,1- 6 días,Otras malformaciones congénitas del corazón,46,27,19
2013,1- 6 días,Coagulación intravascular diseminada en el feto y el recién nacido,30,19,11
2013,1- 6 días,"Malformaciones congénitas del sistema osteomuscular, no clasificadas en otra parte",24,13,11
2013,1- 6 días,Anencefalia y malformaciones congénitas similares,17,10,7
2013,1- 6 días,Hemorragia pulmonar originada en el período perinatal,16,9,7
2013,1- 6 días,Hemorragia intracraneal no traumática del feto y del recién nacido,16,5,11
2013,1- 6 días,Otras afecciones originadas en el período perinatal,16,12,4
2013,1- 6 días,"Síntomas, signos y hallazgos anormales clínicos y de laboratorio, no clasificados en otra parte",26,14,12
2013,1- 6 días,Otras causas,183,106,77
2013,7 - 27 días,Sepsis bacteriana del recién nacido,273,147,126
2013,7 - 27 días,Neumonía congénita,209,123,86
2013,7 - 27 días,Dificultad respiratoria del recién nacido,183,107,76
2013,7 - 27 días,Síndromes de aspiración neonatal,112,59,53
2013,7 - 27 días,Enterocolitis necrotizante del feto y del recién nacido,67,42,25
2013,7 - 27 días,Asfixia del nacimiento,59,36,23
2013,7 - 27 días,Trastornos cardiovasculares originados en el período perinatal,56,30,26
2013,7 - 27 días,Otras malformaciones congénitas del corazón,56,29,27
2013,7 - 27 días,"Otras malformaciones congénitas, no clasificadas en otra parte",52,26,26
2013,7 - 27 días,Coagulación intravascular diseminada en el feto y el recién nacido,36,22,14
2013,7 - 27 días,Hemorragia intracraneal no traumática del feto y del recién nacido,34,17,17
2013,7 - 27 días,"Trastornos relacionados con duración corta de la gestación y con bajo peso al nacer, no clasificados en otra parte",28,17,11
2013,7 - 27 días,Otras afecciones originadas en el período perinatal,26,16,10
2013,7 - 27 días,"Neumonía, organismo no especificado",22,12,10
2013,7 - 27 días,Hemorragia pulmonar originada en el período perinatal,21,12,9
2013,7 - 27 días,"Síntomas, signos y hallazgos anormales clínicos y de laboratorio, no clasificados en otra parte",59,32,27
2013,7 - 27 días,Otras causas,324,171,153
2013,28 días a menos de 1 año,"Neumonía, organismo no especificado",1466,787,679
2013,28 días a menos de 1 año,Diarrea y gastroenteritis de presunto origen infeccioso,397,205,192
2013,28 días a menos de 1 año,Otras septicemias,174,100,74
2013,28 días a menos de 1 año,Otras malformaciones congénitas del corazón,148,79,69
2013,28 días a menos de 1 año,"Otras malformaciones congénitas, no clasificadas en otra parte",99,54,45
2013,28 días a menos de 1 año,Sepsis bacteriana del recién nacido,96,53,43
2013,28 días a menos de 1 año,Neumonía congénita,75,46,29
2013,28 días a menos de 1 año,"Desnutrición proteicocalórica, no especificada",70,40,30
2013,28 días a menos de 1 año,"Desnutrición proteicocalórica severa, no especificada",69,29,40
2013,28 días a menos de 1 año,"Neumonía bacteriana, no clasificada en otra parte",65,40,25
2013,28 días a menos de 1 año,Obstrucción no especificada de la respiración,65,32,33
2013,28 días a menos de 1 año,Síndrome de Down,42,14,28
2013,28 días a menos de 1 año,Dificultad respiratoria del recién nacido,39,20,19
2013,28 días a menos de 1 año,Coagulación intravascular diseminada [síndrome de desfibrinación],31,16,15
2013,28 días a menos de 1 año,Ileo paralítico y obstrucción intestinal sin hernia,31,18,13
2013,28 días a menos de 1 año,"Síntomas, signos y hallazgos anormales clínicos y de laboratorio, no clasificados en otra parte",276,148,128
2013,28 días a menos de 1 año,Otras causas,1011,554,457
2013,1 año,"Neumonía, organismo no especificado",469,253,216
2013,1 año,Diarrea y gastroenteritis de presunto origen infeccioso,411,220,191
2013,1 año,Otras septicemias,47,27,20
2013,1 año,"Desnutrición proteicocalórica severa, no especificada",43,24,19
2013,1 año,"Desnutrición proteicocalórica, no especificada",37,17,20
2013,1 año,Otras malformaciones congénitas del corazón,34,14,20
2013,1 año,"Otras malformaciones congénitas, no clasificadas en otra parte",20,7,13
2013,1 año,Exposición a factores no especificados,20,12,8
2013,1 año,"Neumonía bacteriana, no clasificada en otra parte",19,11,8
2013,1 año,Obstrucción no especificada de la respiración,18,12,6
2013,1 año,Depleción del volumen,16,7,9
2013,1 año,"Otros trastornos de los líquidos, de los electrólitos y del equilibrio ácido-básico",15,9,6
2013,1 año,Ahogamiento y sumersión no especificados,15,10,5
2013,1 año,Síndrome de Down,14,9,5
2013,1 año,Hidrocéfalo,13,7,6
2013,1 año,"Síntomas, signos y hallazgos anormales clínicos y de laboratorio, no clasificados en otra parte",112,66,46
2013,1 año,Otras causas,315,158,157
2013,2 años,"Neumonía, organismo no especificado",147,79,68
2013,2 años,Diarrea y gastroenteritis de presunto origen infeccioso,88,41,47
2013,2 años,Exposición a factores no especificados,20,10,10
2013,2 años,"Desnutrición proteicocalórica severa, no especificada",18,6,12
2013,2 años,"Desnutrición proteicocalórica, no especificada",15,4,11
2013,2 años,"Exposición a humos, fuegos o llamas no especificados",10,7,3
2013,2 años,"Neumonía bacteriana, no clasificada en otra parte",9,5,4
2013,2 años,"Accidente de vehículo de motor o sin motor, tipo de vehículo no especificado",9,3,6
2013,2 años,Otras septicemias,8,6,2
2013,2 años,Obstrucción no especificada de la respiración,7,3,4
2013,2 años,Depleción del volumen,6,3,3
2013,2 años,Neumonitis debida a sólidos y líquidos,5,3,2
2013,2 años,Ahogamiento y sumersión no especificados,5,4,1
2013,2 años,Tumor maligno del ojo y sus anexos,4,2,2
2013,2 años,"Síntomas, signos y hallazgos anormales clínicos y de laboratorio, no clasificados en otra parte",38,23,15
2013,2 años,Otras causas,143,78,65
2013,3 años,"Neumonía, organismo no especificado",75,44,31
2013,3 años,Diarrea y gastroenteritis de presunto origen infeccioso,34,13,21
2013,3 años,"Desnutrición proteicocalórica severa, no especificada",9,4,5
2013,3 años,"Desnutrición proteicocalórica, no especificada",6,4,2
2013,3 años,Obstrucción no especificada de la respiración,6,4,2
2013,3 años,Otras malformaciones congénitas del corazón,5,2,3
2013,3 años,"Accidente de vehículo de motor o sin motor, tipo de vehículo no especificado",5,4,1
2013,3 años,Leucemia linfoide,4,3,1
2013,3 años,Epilepsia,4,2,2
2013,3 años,Insuficiencia cardíaca,4,2,2
2013,3 años,"Síntomas, signos y hallazgos anormales clínicos y de laboratorio, no clasificados en otra parte",21,11,10
2013,3 años,Otras causas,96,53,43
2013,4 años,"Neumonía, organismo no especificado",49,24,25
2013,4 años,Diarrea y gastroenteritis de presunto origen infeccioso,30,21,9
2013,4 años,Exposición a factores no especificados,15,9,6
2013,4 años,"Accidente de vehículo de motor o sin motor, tipo de vehículo no especificado",7,6,1
2013,4 años,Otras septicemias,6,4,2
2013,4 años,"Desnutrición proteicocalórica, no especificada",5,1,4
2013,4 años,Epilepsia,5,2,3
2013,4 años,Leucemia de células de tipo no especificado,4,1,3
2013,4 años,Meningitis debida a otras causas y a las no especificadas,4,2,2
2013,4 años,Otras malformaciones congénitas del corazón,4,2,2
2013,4 años,Obstrucción no especificada de la respiración,4,2,2
2013,4 años,"Exposición a humos, fuegos o llamas no especificados",4,3,1
2013,4 años,"Parasitosis intestinal, sin otra especificación",3,1,2
2013,4 años,"Síntomas, signos y hallazgos anormales clínicos y de laboratorio, no clasificados en otra parte",19,11,8
2013,4 años,Otras causas,65,34,31
2013,5 - 9 años,"Neumonía, organismo no especificado",110,53,57
2013,5 - 9 años,Diarrea y gastroenteritis de presunto origen infeccioso,65,32,33
2013,5 - 9 años,Exposición a factores no especificados,47,32,15
2013,5 - 9 años,"Accidente de vehículo de motor o sin motor, tipo de vehículo no especificado",28,21,7
2013,5 - 9 años,Otras septicemias,25,11,14
2013,5 - 9 años,Leucemia linfoide,23,16,7
2013,5 - 9 años,Ahogamiento y sumersión no especificados,21,14,7
2013,5 - 9 años,"Desnutrición proteicocalórica, no especificada",15,6,9
2013,5 - 9 años,Epilepsia,14,12,2
2013,5 - 9 años,Leucemia de células de tipo no especificado,13,4,9
2013,5 - 9 años,"Agresión con disparo de otras armas de fuego, y las no especificadas",13,4,9
2013,5 - 9 años,"Desnutrición proteicocalórica severa, no especificada",12,4,8
2013,5 - 9 años,Parálisis cerebral,11,5,6
2013,5 - 9 años,Insuficiencia renal crónica,11,5,6
2013,5 - 9 años,Peritonitis,10,4,6
2013,5 - 9 años,"Síntomas, signos y hallazgos anormales clínicos y de laboratorio, no clasificados en otra parte",41,24,17
2013,5 - 9 años,Otras causas,301,145,156
2013,10 - 14 años,Exposición a factores no especificados,69,46,23
2013,10 - 14 años,"Neumonía, organismo no especificado",66,36,30
2013,10 - 14 años,"Accidente de vehículo de motor o sin motor, tipo de vehículo no especificado",46,34,12
2013,10 - 14 años,Diarrea y gastroenteritis de presunto origen infeccioso,40,23,17
2013,10 - 14 años,"Agresión con disparo de otras armas de fuego, y las no especificadas",39,30,9
2013,10 - 14 años,Ahogamiento y sumersión no especificados,35,25,10
2013,10 - 14 años,Otros estrangulamientos y ahorcamientos accidentales,24,17,7
2013,10 - 14 años,Leucemia de células de tipo no especificado,23,15,8
2013,10 - 14 años,Epilepsia,20,7,13
2013,10 - 14 años,Insuficiencia renal crónica,19,12,7
2013,10 - 14 años,"Disparo de otras armas de fuego, y las no especificadas",19,14,5
2013,10 - 14 años,Obstrucción no especificada de la respiración,17,13,4
2013,10 - 14 años,Otras septicemias,15,10,5
2013,10 - 14 años,Parálisis cerebral,13,6,7
2013,10 - 14 años,Otros trastornos del encéfalo,13,7,6
2013,10 - 14 años,"Síntomas, signos y hallazgos anormales clínicos y de laboratorio, no clasificados en otra parte",60,30,30
2013,10 - 14 años,Otras causas,375,205,170
2013,15 - 19 años,"Agresión con disparo de otras armas de fuego, y las no especificadas",525,454,71
2013,15 - 19 años,Exposición a factores no especificados,206,175,31
2013,15 - 19 años,"Disparo de otras armas de fuego, y las no especificadas",135,121,14
2013,15 - 19 años,"Accidente de vehículo de motor o sin motor, tipo de vehículo no especificado",112,95,17
2013,15 - 19 años,"Neumonía, organismo no especificado",76,40,36
2013,15 - 19 años,Otros estrangulamientos y ahorcamientos accidentales,50,35,15
2013,15 - 19 años,Ahogamiento y sumersión no especificados,47,41,6
2013,15 - 19 años,Insuficiencia renal crónica,43,24,19
2013,15 - 19 años,"Envenenamiento accidental por, y exposición a otros productos químicos y sustancias nocivas, y los no especificados",41,15,26
2013,15 - 19 años,"Envenenamiento accidental por, y exposición a plaguicidas",37,19,18
2013,15 - 19 años,Diarrea y gastroenteritis de presunto origen infeccioso,33,18,15
2013,15 - 19 años,Leucemia linfoide,29,21,8
2013,15 - 19 años,Obstrucción no especificada de la respiración,29,17,12
2013,15 - 19 años,"Envenenamiento autoinfligido intencionalmente por, y exposición a plaguicidas",29,8,21
2013,15 - 19 años,"Lesión autoinfligida intencionalmente por ahorcamiento, estrangulamiento o sofocación",29,22,7
2013,15 - 19 años,"Síntomas, signos y hallazgos anormales clínicos y de laboratorio, no clasificados en otra parte",88,41,47
2013,15 - 19 años,Otras causas,750,372,378
2013,20 - 24 años,"Agresión con disparo de otras armas de fuego, y las no especificadas",672,617,55
2013,20 - 24 años,Exposición a factores no especificados,313,284,29
2013,20 - 24 años,"Accidente de vehículo de motor o sin motor, tipo de vehículo no especificado",168,148,20
2013,20 - 24 años,"Disparo de otras armas de fuego, y las no especificadas",165,145,20
2013,20 - 24 años,"Neumonía, organismo no especificado",71,37,34
2013,20 - 24 años,"Envenenamiento accidental por, y exposición a otros productos químicos y sustancias nocivas, y los no especificados",56,38,18
2013,20 - 24 años,Otros estrangulamientos y ahorcamientos accidentales,43,36,7
2013,20 - 24 años,Agresión con objeto cortante,40,37,3
2013,20 - 24 años,Infarto agudo del miocardio,39,23,16
2013,20 - 24 años,"Envenenamiento accidental por, y exposición a plaguicidas",38,25,13
2013,20 - 24 años,"Lesión autoinfligida intencionalmente por ahorcamiento, estrangulamiento o sofocación",36,32,4
2013,20 - 24 años,Diarrea y gastroenteritis de presunto origen infeccioso,35,22,13
2013,20 - 24 años,Insuficiencia renal crónica,34,16,18
2013,20 - 24 años,"Envenenamiento accidental por, y exposición al alcohol",34,33,1
2013,20 - 24 años,Agresión por medios no especificados,34,30,4
2013,20 - 24 años,"Síntomas, signos y hallazgos anormales clínicos y de laboratorio, no clasificados en otra parte",95,57,38
2013,20 - 24 años,Otras causas,854,494,360
2013,25 - 29 años,"Agresión con disparo de otras armas de fuego, y las no especificadas",548,491,57
2013,25 - 29 años,Exposición a factores no especificados,264,229,35
2013,25 - 29 años,"Accidente de vehículo de motor o sin motor, tipo de vehículo no especificado",146,129,17
2013,25 - 29 años,"Disparo de otras armas de fuego, y las no especificadas",127,111,16
2013,25 - 29 años,"Neumonía, organismo no especificado",96,57,39
2013,25 - 29 años,"Envenenamiento accidental por, y exposición al alcohol",57,54,3
2013,25 - 29 años,Infarto agudo del miocardio,56,39,17
2013,25 - 29 años,Agresión con objeto cortante,54,48,6
2013,25 - 29 años,Fibrosis y cirrosis del hígado,53,42,11
2013,25 - 29 años,Diarrea y gastroenteritis de presunto origen infeccioso,41,26,15
2013,25 - 29 años,Enfermedad alcohólica del hígado,41,39,2
2013,25 - 29 años,Otros estrangulamientos y ahorcamientos accidentales,40,36,4
2013,25 - 29 años,"Envenenamiento accidental por, y exposición a otros productos químicos y sustancias nocivas, y los no especificados",36,26,10
2013,25 - 29 años,Epilepsia,35,19,16
2013,25 - 29 años,"Enfermedad por virus de la inmunodeficiencia humana [VIH], sin otra especificación",33,21,12
2013,25 - 29 años,"Síntomas, signos y hallazgos anormales clínicos y de laboratorio, no clasificados en otra parte",103,60,43
2013,25 - 29 años,Otras causas,961,554,407
2013,30 - 34 años,"Agresión con disparo de otras armas de fuego, y las no especificadas",503,449,54
2013,30 - 34 años,Exposición a factores no especificados,245,216,29
2013,30 - 34 años,"Disparo de otras armas de fuego, y las no especificadas",116,107,9
2013,30 - 34 años,"Accidente de vehículo de motor o sin motor, tipo de vehículo no especificado",101,87,14
2013,30 - 34 años,"Neumonía, organismo no especificado",90,55,35
2013,30 - 34 años,Infarto agudo del miocardio,86,52,34
2013,30 - 34 años,Fibrosis y cirrosis del hígado,85,67,18
2013,30 - 34 años,"Envenenamiento accidental por, y exposición al alcohol",83,78,5
2013,30 - 34 años,Enfermedad alcohólica del hígado,68,61,7
2013,30 - 34 años,"Enfermedad por virus de la inmunodeficiencia humana [VIH], sin otra especificación",50,32,18
2013,30 - 34 años,"Diabetes mellitus, no especificada",47,24,23
2013,30 - 34 años,Agresión con objeto cortante,46,40,6
2013,30 - 34 años,Trastornos mentales y del comportamiento debidos al uso de alcohol,44,42,2
2013,30 - 34 años,Diarrea y gastroenteritis de presunto origen infeccioso,42,31,11
2013,30 - 34 años,Agresión por medios no especificados,37,29,8
2013,30 - 34 años,"Síntomas, signos y hallazgos anormales clínicos y de laboratorio, no clasificados en otra parte",110,80,30
2013,30 - 34 años,Otras causas,1027,552,475
2013,35 - 39 años,"Agresión con disparo de otras armas de fuego, y las no especificadas",408,363,45
2013,35 - 39 años,Exposición a factores no especificados,223,197,26
2013,35 - 39 años,Fibrosis y cirrosis del hígado,129,101,28
2013,35 - 39 años,"Disparo de otras armas de fuego, y las no especificadas",102,92,10
2013,35 - 39 años,"Neumonía, organismo no especificado",100,64,36
2013,35 - 39 años,"Accidente de vehículo de motor o sin motor, tipo de vehículo no especificado",100,81,19
2013,35 - 39 años,Enfermedad alcohólica del hígado,98,87,11
2013,35 - 39 años,Infarto agudo del miocardio,95,70,25
2013,35 - 39 años,"Diabetes mellitus, no especificada",80,39,41
2013,35 - 39 años,"Envenenamiento accidental por, y exposición al alcohol",72,69,3
2013,35 - 39 años,Trastornos mentales y del comportamiento debidos al uso de alcohol,53,49,4
2013,35 - 39 años,"Enfermedad por virus de la inmunodeficiencia humana [VIH], sin otra especificación",45,32,13
2013,35 - 39 años,Diarrea y gastroenteritis de presunto origen infeccioso,41,31,10
2013,35 - 39 años,Insuficiencia renal crónica,38,28,10
2013,35 - 39 años,"Enfermedad por virus de la inmunodeficiencia humana [VIH], resultante en enfermedades infecciosas y parasitarias",29,22,7
2013,35 - 39 años,"Síntomas, signos y hallazgos anormales clínicos y de laboratorio, no clasificados en otra parte",122,83,39
2013,35 - 39 años,Otras causas,1108,613,495
2013,40 - 44 años,"Agresión con disparo de otras armas de fuego, y las no especificadas",278,244,34
2013,40 - 44 años,Exposición a factores no especificados,195,160,35
2013,40 - 44 años,Fibrosis y cirrosis del hígado,138,112,26
2013,40 - 44 años,"Neumonía, organismo no especificado",122,79,43
2013,40 - 44 años,Enfermedad alcohólica del hígado,115,104,11
2013,40 - 44 años,Infarto agudo del miocardio,114,68,46
2013,40 - 44 años,"Diabetes mellitus, no especificada",106,55,51
2013,40 - 44 años,"Envenenamiento accidental por, y exposición al alcohol",88,83,5
2013,40 - 44 años,Trastornos mentales y del comportamiento debidos al uso de alcohol,78,70,8
2013,40 - 44 años,"Accidente de vehículo de motor o sin motor, tipo de vehículo no especificado",68,57,11
2013,40 - 44 años,"Disparo de otras armas de fuego, y las no especificadas",57,45,12
2013,40 - 44 años,Insuficiencia renal crónica,54,30,24
2013,40 - 44 años,"Accidente vascular encefálico agudo, no especificado como hemorrágico o isquémico",49,17,32
2013,40 - 44 años,Tumor maligno del estómago,44,20,24
2013,40 - 44 años,"Síntomas, signos y hallazgos anormales clínicos y de laboratorio, no clasificados en otra parte",119,69,50
2013,40 - 44 años,Otras causas,1129,639,490
2013,45 - 49 años,"Diabetes mellitus, no especificada",200,98,102
2013,45 - 49 años,"Agresión con disparo de otras armas de fuego, y las no especificadas",180,154,26
2013,45 - 49 años,Exposición a factores no especificados,176,150,26
2013,45 - 49 años,Infarto agudo del miocardio,165,113,52
2013,45 - 49 años,Fibrosis y cirrosis del hígado,158,122,36
2013,45 - 49 años,"Neumonía, organismo no especificado",123,64,59
2013,45 - 49 años,Enfermedad alcohólica del hígado,108,91,17
2013,45 - 49 años,"Envenenamiento accidental por, y exposición al alcohol",98,89,9
2013,45 - 49 años,Diabetes mellitus no insulinodependiente,86,35,51
2013,45 - 49 años,"Accidente de vehículo de motor o sin motor, tipo de vehículo no especificado",72,59,13
2013,45 - 49 años,Tumor maligno del estómago,64,27,37
2013,45 - 49 años,Trastornos mentales y del comportamiento debidos al uso de alcohol,63,58,5
2013,45 - 49 años,Insuficiencia renal crónica,63,38,25
2013,45 - 49 años,Tumor maligno del hígado y de las vías biliares intrahepáticas,56,23,33
2013,45 - 49 años,"Disparo de otras armas de fuego, y las no especificadas",54,45,9
2013,45 - 49 años,"Síntomas, signos y hallazgos anormales clínicos y de laboratorio, no clasificados en otra parte",148,90,58
2013,45 - 49 años,Otras causas,118,638,542
2013,50 - 54 años,"Diabetes mellitus, no especificada",328,150,178
2013,50 - 54 años,Infarto agudo del miocardio,204,117,87
2013,50 - 54 años,Fibrosis y cirrosis del hígado,196,134,62
2013,50 - 54 años,Exposición a factores no especificados,145,119,26
2013,50 - 54 años,"Neumonía, organismo no especificado",144,84,60
2013,50 - 54 años,"Agresión con disparo de otras armas de fuego, y las no especificadas",133,113,20
2013,50 - 54 años,Diabetes mellitus no insulinodependiente,118,60,58
2013,50 - 54 años,Enfermedad alcohólica del hígado,104,93,11
2013,50 - 54 años,Tumor maligno del estómago,84,27,57
2013,50 - 54 años,Tumor maligno del hígado y de las vías biliares intrahepáticas,84,34,50
2013,50 - 54 años,Insuficiencia renal crónica,81,34,47
2013,50 - 54 años,"Envenenamiento accidental por, y exposición al alcohol",75,63,12
2013,50 - 54 años,"Accidente vascular encefálico agudo, no especificado como hemorrágico o isquémico",65,29,36
2013,50 - 54 años,"Accidente de vehículo de motor o sin motor, tipo de vehículo no especificado",64,52,12
2013,50 - 54 años,Diarrea y gastroenteritis de presunto origen infeccioso,52,28,24
2013,50 - 54 años,"Síntomas, signos y hallazgos anormales clínicos y de laboratorio, no clasificados en otra parte",174,108,66
2013,50 - 54 años,Otras causas,1354,687,667
2013,55 - 59 años,"Diabetes mellitus, no especificada",437,176,261
2013,55 - 59 años,Infarto agudo del miocardio,263,152,111
2013,55 - 59 años,Fibrosis y cirrosis del hígado,227,144,83
2013,55 - 59 años,"Neumonía, organismo no especificado",187,104,83
2013,55 - 59 años,Diabetes mellitus no insulinodependiente,145,61,84
2013,55 - 59 años,Tumor maligno del estómago,133,57,76
2013,55 - 59 años,Exposición a factores no especificados,131,114,17
2013,55 - 59 años,Tumor maligno del hígado y de las vías biliares intrahepáticas,119,46,73
2013,55 - 59 años,Insuficiencia renal crónica,108,63,45
2013,55 - 59 años,Enfermedad alcohólica del hígado,89,73,16
2013,55 - 59 años,"Agresión con disparo de otras armas de fuego, y las no especificadas",84,76,8
2013,55 - 59 años,"Accidente vascular encefálico agudo, no especificado como hemorrágico o isquémico",78,34,44
2013,55 - 59 años,Insuficiencia renal no especificada,73,31,42
2013,55 - 59 años,Insuficiencia cardíaca,68,36,32
2013,55 - 59 años,Diarrea y gastroenteritis de presunto origen infeccioso,66,39,27
2013,55 - 59 años,"Síntomas, signos y hallazgos anormales clínicos y de laboratorio, no clasificados en otra parte",199,105,94
2013,55 - 59 años,Otras causas,1672,915,757
2013,60 - 64 años,"Diabetes mellitus, no especificada",559,225,334
2013,60 - 64 años,Infarto agudo del miocardio,356,211,145
2013,60 - 64 años,Fibrosis y cirrosis del hígado,228,124,104
2013,60 - 64 años,"Neumonía, organismo no especificado",225,121,104
2013,60 - 64 años,Tumor maligno del hígado y de las vías biliares intrahepáticas,188,77,111
2013,60 - 64 años,Diabetes mellitus no insulinodependiente,179,71,108
2013,60 - 64 años,Exposición a factores no especificados,151,116,35
2013,60 - 64 años,Tumor maligno del estómago,133,63,70
2013,60 - 64 años,Insuficiencia renal crónica,130,60,70
2013,60 - 64 años,"Accidente vascular encefálico agudo, no especificado como hemorrágico o isquémico",120,64,56
2013,60 - 64 años,Diarrea y gastroenteritis de presunto origen infeccioso,83,29,54
2013,60 - 64 años,Insuficiencia cardíaca,82,33,49
2013,60 - 64 años,Insuficiencia renal no especificada,77,35,42
2013,60 - 64 años,Enfermedad alcohólica del hígado,71,62,9
2013,60 - 64 años,"Agresión con disparo de otras armas de fuego, y las no especificadas",57,51,6
2013,60 - 64 años,"Síntomas, signos y hallazgos anormales clínicos y de laboratorio, no clasificados en otra parte",230,122,108
2013,60 - 64 años,Otras causas,1721,884,837
2013,65 - 69 años,"Diabetes mellitus, no especificada",513,183,330
2013,65 - 69 años,Infarto agudo del miocardio,381,227,154
2013,65 - 69 años,"Neumonía, organismo no especificado",341,177,164
2013,65 - 69 años,Fibrosis y cirrosis del hígado,208,108,100
2013,65 - 69 años,Tumor maligno del hígado y de las vías biliares intrahepáticas,190,82,108
2013,65 - 69 años,Diabetes mellitus no insulinodependiente,174,78,96
2013,65 - 69 años,Insuficiencia renal crónica,164,87,77
2013,65 - 69 años,Tumor maligno del estómago,155,73,82
2013,65 - 69 años,"Accidente vascular encefálico agudo, no especificado como hemorrágico o isquémico",129,67,62
2013,65 - 69 años,Exposición a factores no especificados,108,79,29
2013,65 - 69 años,Insuficiencia cardíaca,107,36,71
2013,65 - 69 años,Insuficiencia renal no especificada,97,48,49
2013,65 - 69 años,"Desnutrición proteicocalórica, no especificada",86,40,46
2013,65 - 69 años,Diarrea y gastroenteritis de presunto origen infeccioso,80,38,42
2013,65 - 69 años,Otras enfermedades cerebrovasculares,63,29,34
2013,65 - 69 años,"Síntomas, signos y hallazgos anormales clínicos y de laboratorio, no clasificados en otra parte",266,145,121
2013,65 - 69 años,Otras causas,1797,988,809
2013,70 - 74 años,Infarto agudo del miocardio,477,259,218
2013,70 - 74 años,"Diabetes mellitus, no especificada",451,176,275
2013,70 - 74 años,"Neumonía, organismo no especificado",414,208,206
2013,70 - 74 años,Tumor maligno del estómago,201,103,98
2013,70 - 74 años,"Accidente vascular encefálico agudo, no especificado como hemorrágico o isquémico",187,88,99
2013,70 - 74 años,Insuficiencia cardíaca,183,85,98
2013,70 - 74 años,Tumor maligno del hígado y de las vías biliares intrahepáticas,178,84,94
2013,70 - 74 años,Fibrosis y cirrosis del hígado,152,80,72
2013,70 - 74 años,Diabetes mellitus no insulinodependiente,149,64,85
2013,70 - 74 años,Exposición a factores no especificados,125,88,37
2013,70 - 74 años,Insuficiencia renal crónica,121,57,64
2013,70 - 74 años,"Desnutrición proteicocalórica, no especificada",107,58,49
2013,70 - 74 años,Diarrea y gastroenteritis de presunto origen infeccioso,105,49,56
2013,70 - 74 años,Insuficiencia renal no especificada,105,59,46
2013,70 - 74 años,Otras enfermedades cerebrovasculares,86,51,35
2013,70 - 74 años,"Síntomas, signos y hallazgos anormales clínicos y de laboratorio, no clasificados en otra parte",393,205,188
2013,70 - 74 años,Otras causas,1858,999,859
2013,75 - 79 años,"Neumonía, organismo no especificado",616,305,311
2013,75 - 79 años,Infarto agudo del miocardio,524,276,248
2013,75 - 79 años,"Diabetes mellitus, no especificada",457,181,276
2013,75 - 79 años,Insuficiencia cardíaca,258,123,135
2013,75 - 79 años,"Accidente vascular encefálico agudo, no especificado como hemorrágico o isquémico",256,121,135
2013,75 - 79 años,"Desnutrición proteicocalórica, no especificada",190,97,93
2013,75 - 79 años,Tumor maligno del hígado y de las vías biliares intrahepáticas,173,80,93
2013,75 - 79 años,Tumor maligno del estómago,161,82,79
2013,75 - 79 años,Fibrosis y cirrosis del hígado,155,79,76
2013,75 - 79 años,Diarrea y gastroenteritis de presunto origen infeccioso,132,61,71
2013,75 - 79 años,Diabetes mellitus no insulinodependiente,131,52,79
2013,75 - 79 años,Exposición a factores no especificados,128,87,41
2013,75 - 79 años,Otras enfermedades pulmonares obstructivas crónicas,103,55,48
2013,75 - 79 años,Otras enfermedades cerebrovasculares,94,45,49
2013,75 - 79 años,"Síntomas, signos y hallazgos anormales clínicos y de laboratorio, no clasificados en otra parte",484,256,228
2013,75 - 79 años,Otras causas,1925,102,905
2013,80 - 84 años,"Neumonía, organismo no especificado",746,364,382
2013,80 - 84 años,Infarto agudo del miocardio,704,343,361
2013,80 - 84 años,"Diabetes mellitus, no especificada",342,142,200
2013,80 - 84 años,"Accidente vascular encefálico agudo, no especificado como hemorrágico o isquémico",320,144,176
2013,80 - 84 años,Insuficiencia cardíaca,318,152,166
2013,80 - 84 años,"Desnutrición proteicocalórica, no especificada",220,113,107
2013,80 - 84 años,Tumor maligno del estómago,153,74,79
2013,80 - 84 años,Otras enfermedades pulmonares obstructivas crónicas,141,78,63
2013,80 - 84 años,Diarrea y gastroenteritis de presunto origen infeccioso,131,64,67
2013,80 - 84 años,Otras enfermedades cerebrovasculares,131,62,69
2013,80 - 84 años,Exposición a factores no especificados,120,69,51
2013,80 - 84 años,Diabetes mellitus no insulinodependiente,116,43,73
2013,80 - 84 años,Insuficiencia renal crónica,111,63,48
2013,80 - 84 años,Tumor maligno del hígado y de las vías biliares intrahepáticas,109,57,52
2013,80 - 84 años,"Síntomas, signos y hallazgos anormales clínicos y de laboratorio, no clasificados en otra parte",769,375,394
2013,80 - 84 años,Otras causas,1915,968,947
2013,85 y más,"Neumonía, organismo no especificado",1366,685,681
2013,85 y más,Infarto agudo del miocardio,1298,600,698
2013,85 y más,Insuficiencia cardíaca,557,266,291
2013,85 y más,"Accidente vascular encefálico agudo, no especificado como hemorrágico o isquémico",483,208,275
2013,85 y más,"Desnutrición proteicocalórica, no especificada",398,172,226
2013,85 y más,"Diabetes mellitus, no especificada",302,104,198
2013,85 y más,Otras enfermedades pulmonares obstructivas crónicas,219,105,114
2013,85 y más,Otras enfermedades cerebrovasculares,213,100,113
2013,85 y más,Hipertensión esencial (primaria),186,69,117
2013,85 y más,Diarrea y gastroenteritis de presunto origen infeccioso,172,105,67
2013,85 y más,Tumor maligno del estómago,157,68,89
2013,85 y más,Exposición a factores no especificados,147,61,86
2013,85 y más,Insuficiencia renal crónica,134,69,65
2013,85 y más,Diabetes mellitus no insulinodependiente,129,48,81
2013,85 y más,"Síntomas, signos y hallazgos anormales clínicos y de laboratorio, no clasificados en otra parte",1422,631,791
2013,85 y más,Otras causas,2329,1066,1263
2014,1- 6 días,Dificultad respiratoria del recién nacido,381,233,148
2014,1- 6 días,Síndromes de aspiración neonatal,210,107,103
2014,1- 6 días,Sepsis bacteriana del recién nacido,129,75,54
2014,1- 6 días,"Otras malformaciones congénitas, no clasificadas en otra parte",124,76,48
2014,1- 6 días,Asfixia del nacimiento,92,44,48
2014,1- 6 días,"Trastornos relacionados con duración corta de la gestación y con bajo peso al nacer, no clasificados en otra parte",71,41,30
2014,1- 6 días,Trastornos cardiovasculares originados en el período perinatal,67,46,21
2014,1- 6 días,Neumonía congénita,51,34,17
2014,1- 6 días,Otras malformaciones congénitas del corazón,50,26,24
2014,1- 6 días,Coagulación intravascular diseminada en el feto y el recién nacido,33,21,12
2014,1- 6 días,Anencefalia y malformaciones congénitas similares,31,11,20
2014,1- 6 días,Hemorragia pulmonar originada en el período perinatal,28,16,12
2014,1- 6 días,Malformaciones congénitas del pulmón,18,9,9
2014,1- 6 días,Hemorragia intracraneal no traumática del feto y del recién nacido,17,7,10
2014,1- 6 días,"Malformaciones congénitas del sistema osteomuscular, no clasificadas en otra parte",17,13,4
2014,1- 6 días,"Síntomas, signos y hallazgos anormales clínicos y de laboratorio, no clasificados en otra parte",40,23,17
2014,1- 6 días,Otras causas,228,132,96
2014,7 - 27 días,Sepsis bacteriana del recién nacido,331,196,135
2014,7 - 27 días,Dificultad respiratoria del recién nacido,222,125,97
2014,7 - 27 días,Neumonía congénita,154,78,76
2014,7 - 27 días,Síndromes de aspiración neonatal,144,81,63
2014,7 - 27 días,"Otras malformaciones congénitas, no clasificadas en otra parte",84,39,45
2014,7 - 27 días,Asfixia del nacimiento,67,45,22
2014,7 - 27 días,Trastornos cardiovasculares originados en el período perinatal,58,37,21
2014,7 - 27 días,Coagulación intravascular diseminada en el feto y el recién nacido,53,32,21
2014,7 - 27 días,Enterocolitis necrotizante del feto y del recién nacido,52,21,31
2014,7 - 27 días,Otras malformaciones congénitas del corazón,49,31,18
2014,7 - 27 días,Hemorragia pulmonar originada en el período perinatal,42,22,20
2014,7 - 27 días,"Trastornos relacionados con duración corta de la gestación y con bajo peso al nacer, no clasificados en otra parte",34,20,14
2014,7 - 27 días,Otras afecciones originadas en el período perinatal,29,13,16
2014,7 - 27 días,"Malformaciones congénitas del sistema osteomuscular, no clasificadas en otra parte",29,13,16
2014,7 - 27 días,"Enfisema intersticial y afecciones relacionadas, originadas en el período perinatal",28,16,12
2014,7 - 27 días,"Síntomas, signos y hallazgos anormales clínicos y de laboratorio, no clasificados en otra parte",58,29,29
2014,7 - 27 días,Otras causas,301,172,129
2014,28 días a menos de 1 año,"Neumonía, organismo no especificado",1053,575,478
2014,28 días a menos de 1 año,Diarrea y gastroenteritis de presunto origen infeccioso,373,211,162
2014,28 días a menos de 1 año,Otras septicemias,281,166,115
2014,28 días a menos de 1 año,Otras malformaciones congénitas del corazón,205,107,98
2014,28 días a menos de 1 año,Sepsis bacteriana del recién nacido,104,58,46
2014,28 días a menos de 1 año,Dificultad respiratoria del recién nacido,91,57,34
2014,28 días a menos de 1 año,"Otras malformaciones congénitas, no clasificadas en otra parte",90,50,40
2014,28 días a menos de 1 año,Coagulación intravascular diseminada [síndrome de desfibrinación],68,42,26
2014,28 días a menos de 1 año,"Desnutrición proteicocalórica, no especificada",58,26,32
2014,28 días a menos de 1 año,Obstrucción no especificada de la respiración,58,33,25
2014,28 días a menos de 1 año,"Desnutrición proteicocalórica severa, no especificada",51,23,28
2014,28 días a menos de 1 año,"Neumonía bacteriana, no clasificada en otra parte",43,23,20
2014,28 días a menos de 1 año,Síndromes de aspiración neonatal,41,24,17
2014,28 días a menos de 1 año,Neumonía congénita,40,22,18
2014,28 días a menos de 1 año,Asfixia del nacimiento,38,25,13
2014,28 días a menos de 1 año,"Síntomas, signos y hallazgos anormales clínicos y de laboratorio, no clasificados en otra parte",235,123,112
2014,28 días a menos de 1 año,Otras causas,1076,614,462
2014,1 año,"Neumonía, organismo no especificado",361,188,173
2014,1 año,Diarrea y gastroenteritis de presunto origen infeccioso,360,201,159
2014,1 año,Otras septicemias,76,41,35
2014,1 año,"Desnutrición proteicocalórica, no especificada",33,15,18
2014,1 año,"Desnutrición proteicocalórica severa, no especificada",32,12,20
2014,1 año,Exposición a factores no especificados,28,8,20
2014,1 año,"Otros trastornos de los líquidos, de los electrólitos y del equilibrio ácido-básico",23,13,10
2014,1 año,Obstrucción no especificada de la respiración,22,16,6
2014,1 año,Epilepsia,16,9,7
2014,1 año,Otras malformaciones congénitas del corazón,16,7,9
2014,1 año,Coagulación intravascular diseminada [síndrome de desfibrinación],15,7,8
2014,1 año,Ahogamiento y sumersión no especificados,14,6,8
2014,1 año,Depleción del volumen,13,10,3
2014,1 año,Otras enfermedades del sistema digestivo,13,7,6
2014,1 año,"Otras malformaciones congénitas, no clasificadas en otra parte",13,7,6
2014,1 año,"Síntomas, signos y hallazgos anormales clínicos y de laboratorio, no clasificados en otra parte",69,35,34
2014,1 año,Otras causas,318,172,146
2014,2 años,"Neumonía, organismo no especificado",104,42,62
2014,2 años,Diarrea y gastroenteritis de presunto origen infeccioso,93,53,40
2014,2 años,Otras septicemias,23,11,12
2014,2 años,"Desnutrición proteicocalórica, no especificada",17,5,12
2014,2 años,Obstrucción no especificada de la respiración,14,5,9
2014,2 años,Ahogamiento y sumersión no especificados,13,10,3
2014,2 años,Exposición a factores no especificados,11,8,3
2014,2 años,"Desnutrición proteicocalórica severa, no especificada",9,2,7
2014,2 años,"Otros trastornos de los líquidos, de los electrólitos y del equilibrio ácido-básico",9,6,3
2014,2 años,"Exposición a humos, fuegos o llamas no especificados",9,6,3
2014,2 años,Otras malformaciones congénitas del corazón,7,4,3
2014,2 años,Epilepsia,6,3,3
2014,2 años,"Insuficiencia respiratoria, no clasificada en otra parte",6,3,3
2014,2 años,Otras malformaciones congénitas del encéfalo,6,2,4
2014,2 años,Síndrome de Down,6,2,4
2014,2 años,"Síntomas, signos y hallazgos anormales clínicos y de laboratorio, no clasificados en otra parte",36,17,19
2014,2 años,Otras causas,155,77,78
2014,3 años,"Neumonía, organismo no especificado",58,25,33
2014,3 años,Diarrea y gastroenteritis de presunto origen infeccioso,39,19,20
2014,3 años,Exposición a factores no especificados,16,10,6
2014,3 años,"Exposición a humos, fuegos o llamas no especificados",8,3,5
2014,3 años,"Otras malformaciones congénitas, no clasificadas en otra parte",7,4,3
2014,3 años,Síndrome de Down,6,4,2
2014,3 años,"Accidente de vehículo de motor o sin motor, tipo de vehículo no especificado",6,3,3
2014,3 años,Ahogamiento y sumersión no especificados,6,3,3
2014,3 años,Obstrucción no especificada de la respiración,6,2,4
2014,3 años,Otras septicemias,5,4,1
2014,3 años,"Otros trastornos de los líquidos, de los electrólitos y del equilibrio ácido-básico",5,3,2
2014,3 años,Epilepsia,5,2,3
2014,3 años,Otras malformaciones congénitas del encéfalo,5,2,3
2014,3 años,Otras malformaciones congénitas del corazón,5,4,1
2014,3 años,"Parasitosis intestinal, sin otra especificación",4,3,1
2014,3 años,"Síntomas, signos y hallazgos anormales clínicos y de laboratorio, no clasificados en otra parte",23,12,11
2014,3 años,Otras causas,91,52,39
2014,4 años,Diarrea y gastroenteritis de presunto origen infeccioso,32,15,17
2014,4 años,"Neumonía, organismo no especificado",32,13,19
2014,4 años,Otras septicemias,12,6,6
2014,4 años,Exposición a factores no especificados,9,1,8
2014,4 años,"Parasitosis intestinal, sin otra especificación",5,4,1
2014,4 años,"Desnutrición proteicocalórica severa, no especificada",5,4,1
2014,4 años,Epilepsia,5,3,2
2014,4 años,Leucemia de células de tipo no especificado,4,3,1
2014,4 años,Otras malformaciones congénitas del encéfalo,3,1,2
2014,4 años,Otras malformaciones congénitas del corazón,3,1,2
2014,4 años,"Otras malformaciones congénitas, no clasificadas en otra parte",3,2,1
2014,4 años,"Síntomas, signos y hallazgos anormales clínicos y de laboratorio, no clasificados en otra parte",14,5,9
2014,4 años,Otras causas,64,28,36
2014,5 - 9 años,"Neumonía, organismo no especificado",94,48,46
2014,5 - 9 años,Diarrea y gastroenteritis de presunto origen infeccioso,79,45,34
2014,5 - 9 años,Exposición a factores no especificados,71,48,23
2014,5 - 9 años,"Accidente de vehículo de motor o sin motor, tipo de vehículo no especificado",26,12,14
2014,5 - 9 años,Ahogamiento y sumersión no especificados,25,15,10
2014,5 - 9 años,Parálisis cerebral,20,8,12
2014,5 - 9 años,Otras septicemias,18,10,8
2014,5 - 9 años,Epilepsia,18,10,8
2014,5 - 9 años,Leucemia de células de tipo no especificado,15,8,7
2014,5 - 9 años,Leucemia linfoide,13,7,6
2014,5 - 9 años,Obstrucción no especificada de la respiración,12,8,4
2014,5 - 9 años,"Desnutrición proteicocalórica, no especificada",11,5,6
2014,5 - 9 años,Otras malformaciones congénitas del corazón,11,4,7
2014,5 - 9 años,Tumor maligno del encéfalo,10,6,4
2014,5 - 9 años,"Agresión con disparo de otras armas de fuego, y las no especificadas",10,5,5
2014,5 - 9 años,"Síntomas, signos y hallazgos anormales clínicos y de laboratorio, no clasificados en otra parte",37,25,12
2014,5 - 9 años,Otras causas,280,150,130
2014,10 - 14 años,"Neumonía, organismo no especificado",69,38,31
2014,10 - 14 años,Exposición a factores no especificados,54,38,16
2014,10 - 14 años,Diarrea y gastroenteritis de presunto origen infeccioso,41,20,21
2014,10 - 14 años,"Agresión con disparo de otras armas de fuego, y las no especificadas",40,27,13
2014,10 - 14 años,"Accidente de vehículo de motor o sin motor, tipo de vehículo no especificado",32,20,12
2014,10 - 14 años,Ahogamiento y sumersión no especificados,29,23,6
2014,10 - 14 años,Otros estrangulamientos y ahorcamientos accidentales,21,11,10
2014,10 - 14 años,Otras septicemias,20,11,9
2014,10 - 14 años,Insuficiencia renal crónica,19,9,10
2014,10 - 14 años,Epilepsia,17,10,7
2014,10 - 14 años,"Disparo de otras armas de fuego, y las no especificadas",17,12,5
2014,10 - 14 años,Leucemia linfoide,16,7,9
2014,10 - 14 años,Insuficiencia renal no especificada,16,11,5
2014,10 - 14 años,Obstrucción no especificada de la respiración,13,8,5
2014,10 - 14 años,"Lesión autoinfligida intencionalmente por ahorcamiento, estrangulamiento o sofocación",11,5,6
2014,10 - 14 años,"Síntomas, signos y hallazgos anormales clínicos y de laboratorio, no clasificados en otra parte",54,25,29
2014,10 - 14 años,Otras causas,385,181,204
2014,15 - 19 años,"Agresión con disparo de otras armas de fuego, y las no especificadas",527,456,71
2014,15 - 19 años,Exposición a factores no especificados,182,163,19
2014,15 - 19 años,"Disparo de otras armas de fuego, y las no especificadas",134,116,18
2014,15 - 19 años,"Accidente de vehículo de motor o sin motor, tipo de vehículo no especificado",122,108,14
2014,15 - 19 años,"Neumonía, organismo no especificado",65,38,27
2014,15 - 19 años,Ahogamiento y sumersión no especificados,58,51,7
2014,15 - 19 años,Otros estrangulamientos y ahorcamientos accidentales,48,33,15
2014,15 - 19 años,Diarrea y gastroenteritis de presunto origen infeccioso,47,28,19
2014,15 - 19 años,"Lesión autoinfligida intencionalmente por ahorcamiento, estrangulamiento o sofocación",44,30,14
2014,15 - 19 años,Agresión con objeto cortante,42,31,11
2014,15 - 19 años,Insuficiencia renal crónica,41,22,19
2014,15 - 19 años,"Envenenamiento autoinfligido intencionalmente por, y exposición a otros productos químicos y sustancias nocivas, y los no especificados",36,7,29
2014,15 - 19 años,Infarto agudo del miocardio,34,18,16
2014,15 - 19 años,Leucemia linfoide,29,16,13
2014,15 - 19 años,Otras septicemias,28,12,16
2014,15 - 19 años,"Síntomas, signos y hallazgos anormales clínicos y de laboratorio, no clasificados en otra parte",108,54,54
2014,15 - 19 años,Otras causas,797,411,386
2014,20 - 24 años,"Agresión con disparo de otras armas de fuego, y las no especificadas",668,610,58
2014,20 - 24 años,Exposición a factores no especificados,306,272,34
2014,20 - 24 años,"Accidente de vehículo de motor o sin motor, tipo de vehículo no especificado",201,186,15
2014,20 - 24 años,"Disparo de otras armas de fuego, y las no especificadas",171,160,11
2014,20 - 24 años,"Neumonía, organismo no especificado",83,49,34
2014,20 - 24 años,Infarto agudo del miocardio,53,37,16
2014,20 - 24 años,Agresión con objeto cortante,46,40,6
2014,20 - 24 años,Ahogamiento y sumersión no especificados,44,36,8
2014,20 - 24 años,Epilepsia,43,30,13
2014,20 - 24 años,Otros estrangulamientos y ahorcamientos accidentales,43,38,5
2014,20 - 24 años,Diarrea y gastroenteritis de presunto origen infeccioso,39,25,14
2014,20 - 24 años,Agresión por medios no especificados,37,34,3
2014,20 - 24 años,"Envenenamiento accidental por, y exposición a otros productos químicos y sustancias nocivas, y los no especificados",30,15,15
2014,20 - 24 años,Otras septicemias,28,19,9
2014,20 - 24 años,"Envenenamiento autoinfligido intencionalmente por, y exposición a plaguicidas",27,19,8
2014,20 - 24 años,"Síntomas, signos y hallazgos anormales clínicos y de laboratorio, no clasificados en otra parte",112,77,35
2014,20 - 24 años,Otras causas,916,531,385
2014,25 - 29 años,"Agresión con disparo de otras armas de fuego, y las no especificadas",535,484,51
2014,25 - 29 años,Exposición a factores no especificados,274,246,28
2014,25 - 29 años,"Accidente de vehículo de motor o sin motor, tipo de vehículo no especificado",151,135,16
2014,25 - 29 años,"Disparo de otras armas de fuego, y las no especificadas",142,125,17
2014,25 - 29 años,"Neumonía, organismo no especificado",86,52,34
2014,25 - 29 años,"Envenenamiento accidental por, y exposición al alcohol",55,54,1
2014,25 - 29 años,Agresión con objeto cortante,54,50,4
2014,25 - 29 años,Infarto agudo del miocardio,51,37,14
2014,25 - 29 años,Fibrosis y cirrosis del hígado,44,34,10
2014,25 - 29 años,Enfermedad alcohólica del hígado,41,37,4
2014,25 - 29 años,Agresión por medios no especificados,37,32,5
2014,25 - 29 años,Diarrea y gastroenteritis de presunto origen infeccioso,35,20,15
2014,25 - 29 años,Epilepsia,33,18,15
2014,25 - 29 años,Otros estrangulamientos y ahorcamientos accidentales,33,29,4
2014,25 - 29 años,"Enfermedad por virus de la inmunodeficiencia humana [VIH], sin otra especificación",32,13,19
2014,25 - 29 años,"Síntomas, signos y hallazgos anormales clínicos y de laboratorio, no clasificados en otra parte",79,51,28
2014,25 - 29 años,Otras causas,952,534,418
2014,30 - 34 años,"Agresión con disparo de otras armas de fuego, y las no especificadas",455,414,41
2014,30 - 34 años,Exposición a factores no especificados,241,212,29
2014,30 - 34 años,"Accidente de vehículo de motor o sin motor, tipo de vehículo no especificado",120,105,15
2014,30 - 34 años,"Disparo de otras armas de fuego, y las no especificadas",115,103,12
2014,30 - 34 años,Enfermedad alcohólica del hígado,95,88,7
2014,30 - 34 años,Fibrosis y cirrosis del hígado,94,77,17
2014,30 - 34 años,"Neumonía, organismo no especificado",79,49,30
2014,30 - 34 años,"Envenenamiento accidental por, y exposición al alcohol",76,74,2
2014,30 - 34 años,Infarto agudo del miocardio,67,47,20
2014,30 - 34 años,Diarrea y gastroenteritis de presunto origen infeccioso,51,35,16
2014,30 - 34 años,Trastornos mentales y del comportamiento debidos al uso de alcohol,47,44,3
2014,30 - 34 años,"Enfermedad por virus de la inmunodeficiencia humana [VIH], sin otra especificación",46,32,14
2014,30 - 34 años,Agresión con objeto cortante,44,37,7
2014,30 - 34 años,"Diabetes mellitus, no especificada",41,20,21
2014,30 - 34 años,Otros estrangulamientos y ahorcamientos accidentales,35,30,5
2014,30 - 34 años,"Síntomas, signos y hallazgos anormales clínicos y de laboratorio, no clasificados en otra parte",111,75,36
2014,30 - 34 años,Otras causas,1131,652,479
2014,35 - 39 años,"Agresión con disparo de otras armas de fuego, y las no especificadas",386,341,45
2014,35 - 39 años,Exposición a factores no especificados,155,138,17
2014,35 - 39 años,Fibrosis y cirrosis del hígado,137,123,14
2014,35 - 39 años,"Disparo de otras armas de fuego, y las no especificadas",110,92,18
2014,35 - 39 años,Enfermedad alcohólica del hígado,109,99,10
2014,35 - 39 años,"Accidente de vehículo de motor o sin motor, tipo de vehículo no especificado",98,82,16
2014,35 - 39 años,Infarto agudo del miocardio,92,62,30
2014,35 - 39 años,"Neumonía, organismo no especificado",83,50,33
2014,35 - 39 años,"Diabetes mellitus, no especificada",82,42,40
2014,35 - 39 años,"Envenenamiento accidental por, y exposición al alcohol",75,70,5
2014,35 - 39 años,Tumor maligno del estómago,45,18,27
2014,35 - 39 años,Trastornos mentales y del comportamiento debidos al uso de alcohol,45,42,3
2014,35 - 39 años,Agresión con objeto cortante,37,34,3
2014,35 - 39 años,Insuficiencia renal crónica,36,22,14
2014,35 - 39 años,Otras septicemias,35,21,14
2014,35 - 39 años,"Síntomas, signos y hallazgos anormales clínicos y de laboratorio, no clasificados en otra parte",90,57,33
2014,35 - 39 años,Otras causas,1107,580,527
2014,40 - 44 años,"Agresión con disparo de otras armas de fuego, y las no especificadas",239,207,32
2014,40 - 44 años,Exposición a factores no especificados,178,159,19
2014,40 - 44 años,Fibrosis y cirrosis del hígado,166,129,37
2014,40 - 44 años,"Diabetes mellitus, no especificada",132,61,71
2014,40 - 44 años,Enfermedad alcohólica del hígado,127,100,27
2014,40 - 44 años,Infarto agudo del miocardio,112,78,34
2014,40 - 44 años,"Neumonía, organismo no especificado",88,58,30
2014,40 - 44 años,"Envenenamiento accidental por, y exposición al alcohol",81,74,7
2014,40 - 44 años,"Accidente de vehículo de motor o sin motor, tipo de vehículo no especificado",76,60,16
2014,40 - 44 años,"Disparo de otras armas de fuego, y las no especificadas",76,69,7
2014,40 - 44 años,Diabetes mellitus no insulinodependiente,50,22,28
2014,40 - 44 años,Tumor maligno del estómago,49,15,34
2014,40 - 44 años,"Enfermedad por virus de la inmunodeficiencia humana [VIH], sin otra especificación",43,26,17
2014,40 - 44 años,Insuficiencia renal crónica,38,23,15
2014,40 - 44 años,"Síntomas, signos y hallazgos anormales clínicos y de laboratorio, no clasificados en otra parte",106,70,36
2014,40 - 44 años,Otras causas,1151,678,473
2014,45 - 49 años,"Diabetes mellitus, no especificada",226,101,125
2014,45 - 49 años,Exposición a factores no especificados,179,158,21
2014,45 - 49 años,Fibrosis y cirrosis del hígado,177,132,45
2014,45 - 49 años,"Agresión con disparo de otras armas de fuego, y las no especificadas",174,157,17
2014,45 - 49 años,Infarto agudo del miocardio,137,84,53
2014,45 - 49 años,"Neumonía, organismo no especificado",122,75,47
2014,45 - 49 años,Enfermedad alcohólica del hígado,104,92,12
2014,45 - 49 años,"Envenenamiento accidental por, y exposición al alcohol",81,72,9
2014,45 - 49 años,Tumor maligno del hígado y de las vías biliares intrahepáticas,77,26,51
2014,45 - 49 años,"Accidente de vehículo de motor o sin motor, tipo de vehículo no especificado",75,60,15
2014,45 - 49 años,Diabetes mellitus no insulinodependiente,68,26,42
2014,45 - 49 años,Diarrea y gastroenteritis de presunto origen infeccioso,57,32,25
2014,45 - 49 años,"Accidente vascular encefálico agudo, no especificado como hemorrágico o isquémico",57,24,33
2014,45 - 49 años,Insuficiencia renal crónica,53,32,21
2014,45 - 49 años,"Síntomas, signos y hallazgos anormales clínicos y de laboratorio, no clasificados en otra parte",117,77,40
2014,45 - 49 años,Otras causas,1238,685,553
2014,50 - 54 años,"Diabetes mellitus, no especificada",327,124,203
2014,50 - 54 años,Fibrosis y cirrosis del hígado,243,184,59
2014,50 - 54 años,Infarto agudo del miocardio,225,136,89
2014,50 - 54 años,Exposición a factores no especificados,176,150,26
2014,50 - 54 años,"Neumonía, organismo no especificado",154,82,72
2014,50 - 54 años,"Agresión con disparo de otras armas de fuego, y las no especificadas",128,106,22
2014,50 - 54 años,Diabetes mellitus no insulinodependiente,126,45,81
2014,50 - 54 años,Enfermedad alcohólica del hígado,113,96,17
2014,50 - 54 años,Tumor maligno del hígado y de las vías biliares intrahepáticas,108,56,52
2014,50 - 54 años,Tumor maligno del estómago,78,31,47
2014,50 - 54 años,Insuficiencia renal crónica,72,34,38
2014,50 - 54 años,"Accidente vascular encefálico agudo, no especificado como hemorrágico o isquémico",67,38,29
2014,50 - 54 años,"Accidente de vehículo de motor o sin motor, tipo de vehículo no especificado",61,48,13
2014,50 - 54 años,"Envenenamiento accidental por, y exposición al alcohol",61,56,5
2014,50 - 54 años,"Síntomas, signos y hallazgos anormales clínicos y de laboratorio, no clasificados en otra parte",139,77,62
2014,50 - 54 años,Otras causas,1434,782,652
2014,55 - 59 años,"Diabetes mellitus, no especificada",499,189,310
2014,55 - 59 años,Infarto agudo del miocardio,287,161,126
2014,55 - 59 años,Fibrosis y cirrosis del hígado,255,157,98
2014,55 - 59 años,"Neumonía, organismo no especificado",210,106,104
2014,55 - 59 años,Diabetes mellitus no insulinodependiente,177,70,107
2014,55 - 59 años,Exposición a factores no especificados,172,147,25
2014,55 - 59 años,Tumor maligno del hígado y de las vías biliares intrahepáticas,136,51,85
2014,55 - 59 años,Tumor maligno del estómago,128,37,91
2014,55 - 59 años,Insuficiencia renal crónica,96,62,34
2014,55 - 59 años,Enfermedad alcohólica del hígado,85,73,12
2014,55 - 59 años,"Accidente vascular encefálico agudo, no especificado como hemorrágico o isquémico",84,39,45
2014,55 - 59 años,"Agresión con disparo de otras armas de fuego, y las no especificadas",82,72,10
2014,55 - 59 años,"Accidente de vehículo de motor o sin motor, tipo de vehículo no especificado",70,54,16
2014,55 - 59 años,Insuficiencia renal no especificada,62,28,34
2014,55 - 59 años,Diarrea y gastroenteritis de presunto origen infeccioso,61,32,29
2014,55 - 59 años,"Síntomas, signos y hallazgos anormales clínicos y de laboratorio, no clasificados en otra parte",203,107,96
2014,55 - 59 años,Otras causas,1703,850,853
2014,60 - 64 años,"Diabetes mellitus, no especificada",571,241,330
2014,60 - 64 años,Infarto agudo del miocardio,397,229,168
2014,60 - 64 años,"Neumonía, organismo no especificado",266,135,131
2014,60 - 64 años,Fibrosis y cirrosis del hígado,263,133,130
2014,60 - 64 años,Diabetes mellitus no insulinodependiente,209,88,121
2014,60 - 64 años,Tumor maligno del estómago,180,79,101
2014,60 - 64 años,Insuficiencia renal crónica,149,77,72
2014,60 - 64 años,Tumor maligno del hígado y de las vías biliares intrahepáticas,145,58,87
2014,60 - 64 años,Exposición a factores no especificados,138,116,22
2014,60 - 64 años,"Accidente vascular encefálico agudo, no especificado como hemorrágico o isquémico",113,66,47
2014,60 - 64 años,Insuficiencia renal no especificada,96,45,51
2014,60 - 64 años,Enfermedad alcohólica del hígado,75,65,10
2014,60 - 64 años,Diarrea y gastroenteritis de presunto origen infeccioso,69,38,31
2014,60 - 64 años,Insuficiencia cardíaca,67,32,35
2014,60 - 64 años,Otras septicemias,61,31,30
2014,60 - 64 años,"Síntomas, signos y hallazgos anormales clínicos y de laboratorio, no clasificados en otra parte",208,108,100
2014,60 - 64 años,Otras causas,1805,928,877
2014,65 - 69 años,"Diabetes mellitus, no especificada",615,266,349
2014,65 - 69 años,Infarto agudo del miocardio,447,242,205
2014,65 - 69 años,"Neumonía, organismo no especificado",314,170,144
2014,65 - 69 años,Fibrosis y cirrosis del hígado,225,118,107
2014,65 - 69 años,Diabetes mellitus no insulinodependiente,196,77,119
2014,65 - 69 años,Tumor maligno del hígado y de las vías biliares intrahepáticas,179,82,97
2014,65 - 69 años,Tumor maligno del estómago,173,73,100
2014,65 - 69 años,"Accidente vascular encefálico agudo, no especificado como hemorrágico o isquémico",149,81,68
2014,65 - 69 años,Insuficiencia renal crónica,130,70,60
2014,65 - 69 años,Exposición a factores no especificados,125,99,26
2014,65 - 69 años,Diarrea y gastroenteritis de presunto origen infeccioso,96,43,53
2014,65 - 69 años,Insuficiencia renal no especificada,96,53,43
2014,65 - 69 años,Otras septicemias,80,27,53
2014,65 - 69 años,Insuficiencia cardíaca,74,34,40
2014,65 - 69 años,Otras enfermedades cerebrovasculares,72,29,43
2014,65 - 69 años,"Síntomas, signos y hallazgos anormales clínicos y de laboratorio, no clasificados en otra parte",251,125,126
2014,65 - 69 años,Otras causas,1881,1063,818
2014,70 - 74 años,"Diabetes mellitus, no especificada",528,236,292
2014,70 - 74 años,Infarto agudo del miocardio,491,259,232
2014,70 - 74 años,"Neumonía, organismo no especificado",469,245,224
2014,70 - 74 años,"Accidente vascular encefálico agudo, no especificado como hemorrágico o isquémico",223,110,113
2014,70 - 74 años,Diabetes mellitus no insulinodependiente,187,77,110
2014,70 - 74 años,Fibrosis y cirrosis del hígado,187,105,82
2014,70 - 74 años,Tumor maligno del hígado y de las vías biliares intrahepáticas,185,90,95
2014,70 - 74 años,Tumor maligno del estómago,172,84,88
2014,70 - 74 años,Insuficiencia cardíaca,142,63,79
2014,70 - 74 años,Exposición a factores no especificados,131,95,36
2014,70 - 74 años,Insuficiencia renal crónica,119,65,54
2014,70 - 74 años,Otras enfermedades cerebrovasculares,109,55,54
2014,70 - 74 años,Insuficiencia renal no especificada,95,54,41
2014,70 - 74 años,"Desnutrición proteicocalórica, no especificada",89,40,49
2014,70 - 74 años,"Síntomas, signos y hallazgos anormales clínicos y de laboratorio, no clasificados en otra parte",338,161,177
2014,70 - 74 años,Otras causas,1919,1047,872
2014,75 - 79 años,Infarto agudo del miocardio,679,375,304
2014,75 - 79 años,"Neumonía, organismo no especificado",679,346,333
2014,75 - 79 años,"Diabetes mellitus, no especificada",485,203,282
2014,75 - 79 años,"Accidente vascular encefálico agudo, no especificado como hemorrágico o isquémico",294,148,146
2014,75 - 79 años,Diabetes mellitus no insulinodependiente,201,86,115
2014,75 - 79 años,Insuficiencia cardíaca,197,99,98
2014,75 - 79 años,Tumor maligno del estómago,175,86,89
2014,75 - 79 años,"Desnutrición proteicocalórica, no especificada",163,76,87
2014,75 - 79 años,Insuficiencia renal crónica,159,100,59
2014,75 - 79 años,Tumor maligno del hígado y de las vías biliares intrahepáticas,155,70,85
2014,75 - 79 años,Fibrosis y cirrosis del hígado,134,70,64
2014,75 - 79 años,Diarrea y gastroenteritis de presunto origen infeccioso,126,59,67
2014,75 - 79 años,Otras enfermedades cerebrovasculares,118,70,48
2014,75 - 79 años,Exposición a factores no especificados,115,67,48
2014,75 - 79 años,"Síntomas, signos y hallazgos anormales clínicos y de laboratorio, no clasificados en otra parte",449,210,239
2014,75 - 79 años,Otras causas,2041,1055,986
2014,80 - 84 años,"Neumonía, organismo no especificado",850,444,406
2014,80 - 84 años,Infarto agudo del miocardio,792,398,394
2014,80 - 84 años,"Diabetes mellitus, no especificada",393,166,227
2014,80 - 84 años,"Accidente vascular encefálico agudo, no especificado como hemorrágico o isquémico",347,157,190
2014,80 - 84 años,Insuficiencia cardíaca,278,140,138
2014,80 - 84 años,"Desnutrición proteicocalórica, no especificada",212,92,120
2014,80 - 84 años,Tumor maligno del estómago,168,82,86
2014,80 - 84 años,Otras enfermedades pulmonares obstructivas crónicas,138,65,73
2014,80 - 84 años,Exposición a factores no especificados,138,71,67
2014,80 - 84 años,Diabetes mellitus no insulinodependiente,137,52,85
2014,80 - 84 años,Tumor maligno del hígado y de las vías biliares intrahepáticas,136,57,79
2014,80 - 84 años,Otras enfermedades cerebrovasculares,134,70,64
2014,80 - 84 años,Diarrea y gastroenteritis de presunto origen infeccioso,133,57,76
2014,80 - 84 años,Insuficiencia renal crónica,124,59,65
2014,80 - 84 años,"Síntomas, signos y hallazgos anormales clínicos y de laboratorio, no clasificados en otra parte",693,333,360
2014,80 - 84 años,Otras causas,2097,1032,1065
2014,85 y más,Infarto agudo del miocardio,1556,745,811
2014,85 y más,"Neumonía, organismo no especificado",1464,752,712
2014,85 y más,Insuficiencia cardíaca,529,228,301
2014,85 y más,"Accidente vascular encefálico agudo, no especificado como hemorrágico o isquémico",490,256,234
2014,85 y más,"Diabetes mellitus, no especificada",383,143,240
2014,85 y más,"Desnutrición proteicocalórica, no especificada",383,178,205
2014,85 y más,Otras enfermedades pulmonares obstructivas crónicas,262,127,135
2014,85 y más,Hipertensión esencial (primaria),213,103,110
2014,85 y más,Diarrea y gastroenteritis de presunto origen infeccioso,158,76,82
2014,85 y más,Otras enfermedades cerebrovasculares,158,59,99
2014,85 y más,Exposición a factores no especificados,153,81,72
2014,85 y más,Tumor maligno del estómago,146,60,86
2014,85 y más,Insuficiencia renal crónica,146,84,62
2014,85 y más,Insuficiencia renal no especificada,140,63,77
2014,85 y más,"Síntomas, signos y hallazgos anormales clínicos y de laboratorio, no clasificados en otra parte",1383,621,762
2014,85 y más,Otras causas,2461,1157,1304
2015,1- 6 días,Dificultad respiratoria del recién nacido,420,249,171
2015,1- 6 días,Sepsis bacteriana del recién nacido,175,117,58
2015,1- 6 días,"Trastornos relacionados con duración corta de la gestación y con bajo peso al nacer, no clasificados en otra parte",174,105,69
2015,1- 6 días,Neumonía congénita,167,98,69
2015,1- 6 días,Síndromes de aspiración neonatal,161,91,70
2015,1- 6 días,Asfixia del nacimiento,141,83,58
2015,1- 6 días,"Otras malformaciones congénitas, no clasificadas en otra parte",132,69,63
2015,1- 6 días,Trastornos cardiovasculares originados en el período perinatal,127,74,53
2015,1- 6 días,Otras malformaciones congénitas del corazón,73,44,29
2015,1- 6 días,Coagulación intravascular diseminada en el feto y el recién nacido,46,28,18
2015,1- 6 días,Hemorragia pulmonar originada en el período perinatal,44,17,27
2015,1- 6 días,"Otros problemas respiratorios del recién nacido, originados en el período perinatal",29,21,8
2015,1- 6 días,"Enfisema intersticial y afecciones relacionadas, originadas en el período perinatal",20,12,8
2015,1- 6 días,Anencefalia y malformaciones congénitas similares,20,11,9
2015,1- 6 días,Hemorragia intracraneal no traumática del feto y del recién nacido,19,10,9
2015,1- 6 días,"Síntomas, signos y hallazgos anormales clínicos y de laboratorio, no clasificados en otra parte",87,44,43
2015,1- 6 días,Otras causas,309,174,135
2015,7 - 27 días,Neumonía congénita,222,138,84
2015,7 - 27 días,Sepsis bacteriana del recién nacido,177,97,80
2015,7 - 27 días,Dificultad respiratoria del recién nacido,110,67,43
2015,7 - 27 días,"Trastornos relacionados con duración corta de la gestación y con bajo peso al nacer, no clasificados en otra parte",84,39,45
2015,7 - 27 días,Enterocolitis necrotizante del feto y del recién nacido,76,37,39
2015,7 - 27 días,Coagulación intravascular diseminada en el feto y el recién nacido,74,41,33
2015,7 - 27 días,Otras malformaciones congénitas del corazón,68,34,34
2015,7 - 27 días,Trastornos cardiovasculares originados en el período perinatal,52,27,25
2015,7 - 27 días,Síndromes de aspiración neonatal,49,28,21
2015,7 - 27 días,"Otras malformaciones congénitas, no clasificadas en otra parte",45,22,23
2015,7 - 27 días,Asfixia del nacimiento,43,29,14
2015,7 - 27 días,Hemorragia pulmonar originada en el período perinatal,43,26,17
2015,7 - 27 días,Otros trastornos perinatales del sistema digestivo,26,11,15
2015,7 - 27 días,Hemorragia intracraneal no traumática del feto y del recién nacido,23,14,9
2015,7 - 27 días,"Otros problemas respiratorios del recién nacido, originados en el período perinatal",22,17,5
2015,7 - 27 días,"Síntomas, signos y hallazgos anormales clínicos y de laboratorio, no clasificados en otra parte",83,48,35
2015,7 - 27 días,Otras causas,319,191,128
2015,28 días a menos de 1 año,"Neumonía, organismo no especificado",1313,740,573
2015,28 días a menos de 1 año,Otras gastroenteritis y colitis de origen infeccioso y no especificado,405,215,190
2015,28 días a menos de 1 año,Otras sepsis,191,105,86
2015,28 días a menos de 1 año,Otras malformaciones congénitas del corazón,168,86,82
2015,28 días a menos de 1 año,Policitemia vera,77,41,36
2015,28 días a menos de 1 año,"Neumonía bacteriana, no clasificada en otra parte",70,42,28
2015,28 días a menos de 1 año,"Desnutrición proteicocalórica severa, no especificada",58,28,30
2015,28 días a menos de 1 año,"Otras malformaciones congénitas, no clasificadas en otra parte",54,30,24
2015,28 días a menos de 1 año,"Otros trastornos de los líquidos, de los electrólitos y del equilibrio ácido-básico",52,33,19
2015,28 días a menos de 1 año,"Desnutrición proteicocalórica, no especificada",50,25,25
2015,28 días a menos de 1 año,Otros trastornos respiratorios,50,28,22
2015,28 días a menos de 1 año,Afecciones respiratorias debidas a otros agentes externos,48,25,23
2015,28 días a menos de 1 año,Obstrucción no especificada de la respiración,48,21,27
2015,28 días a menos de 1 año,Sepsis bacteriana del recién nacido,41,21,20
2015,28 días a menos de 1 año,Neumotórax,37,25,12
2015,28 días a menos de 1 año,"Síntomas, signos y hallazgos anormales clínicos y de laboratorio, no clasificados en otra parte",466,251,215
2015,28 días a menos de 1 año,Otras causas,1152,650,502
2015,1 año,"Neumonía, organismo no especificado",385,212,173
2015,1 año,Otras gastroenteritis y colitis de origen infeccioso y no especificado,298,145,153
2015,1 año,Otras sepsis,41,26,15
2015,1 año,"Otros trastornos de los líquidos, de los electrólitos y del equilibrio ácido-básico",31,17,14
2015,1 año,"Desnutrición proteicocalórica, no especificada",29,13,16
2015,1 año,Otras malformaciones congénitas del corazón,27,14,13
2015,1 año,"Desnutrición proteicocalórica severa, no especificada",24,8,16
2015,1 año,Amiloidosis,16,10,6
2015,1 año,"Neumonía bacteriana, no clasificada en otra parte",16,8,8
2015,1 año,Obstrucción no especificada de la respiración,16,9,7
2015,1 año,Otros trastornos respiratorios,15,6,9
2015,1 año,Policitemia vera,13,9,4
2015,1 año,Exposición a factores no especificados,12,9,3
2015,1 año,Hidrocéfalo,11,5,6
2015,1 año,"Síntomas, signos y hallazgos anormales clínicos y de laboratorio, no clasificados en otra parte",146,87,59
2015,1 año,Otras causas,321,146,175
2015,2 años,"Neumonía, organismo no especificado",126,68,58
2015,2 años,Otras gastroenteritis y colitis de origen infeccioso y no especificado,82,32,50
2015,2 años,Exposición a factores no especificados,15,7,8
2015,2 años,"Desnutrición proteicocalórica severa, no especificada",13,8,5
2015,2 años,"Desnutrición proteicocalórica, no especificada",11,7,4
2015,2 años,Ahogamiento y sumersión no especificados,10,7,3
2015,2 años,Otras sepsis,9,6,3
2015,2 años,Parálisis cerebral,9,6,3
2015,2 años,Epilepsia,8,4,4
2015,2 años,Otros trastornos respiratorios,8,4,4
2015,2 años,"Accidente de vehículo de motor o sin motor, tipo de vehículo no especificado",8,6,2
2015,2 años,"Exposición a humos, fuegos o llamas no especificados",7,3,4
2015,2 años,Amiloidosis,6,3,3
2015,2 años,"Otros trastornos de los líquidos, de los electrólitos y del equilibrio ácido-básico",6,5,1
2015,2 años,"Neumonía bacteriana, no clasificada en otra parte",6,4,2
2015,2 años,"Síntomas, signos y hallazgos anormales clínicos y de laboratorio, no clasificados en otra parte",63,34,29
2015,2 años,Otras causas,176,86,90
2015,3 años,"Neumonía, organismo no especificado",52,31,21
2015,3 años,Otras gastroenteritis y colitis de origen infeccioso y no especificado,37,19,18
2015,3 años,Exposición a factores no especificados,17,10,7
2015,3 años,"Exposición a humos, fuegos o llamas no especificados",9,3,6
2015,3 años,Otras sepsis,7,2,5
2015,3 años,Ahogamiento y sumersión no especificados,7,2,5
2015,3 años,Epilepsia,6,2,4
2015,3 años,"Accidente de vehículo de motor o sin motor, tipo de vehículo no especificado",6,3,3
2015,3 años,Leucemia linfoide,5,4,1
2015,3 años,Agresión por medios no especificados,5,2,3
2015,3 años,Policitemia vera,4,1,3
2015,3 años,"Otros trastornos de los líquidos, de los electrólitos y del equilibrio ácido-básico",4,3,1
2015,3 años,Otros trastornos respiratorios,4,1,3
2015,3 años,"Obstrucción de la respiración debida a hundimiento, caída de tierra u otras sustancias",4,2,2
2015,3 años,"Desnutrición proteicocalórica severa, no especificada",3,1,2
2015,3 años,"Síntomas, signos y hallazgos anormales clínicos y de laboratorio, no clasificados en otra parte",25,15,10
2015,3 años,Otras causas,101,46,55
2015,4 años,"Neumonía, organismo no especificado",32,18,14
2015,4 años,Otras gastroenteritis y colitis de origen infeccioso y no especificado,30,19,11
2015,4 años,Exposición a factores no especificados,15,11,4
2015,4 años,Otras malformaciones congénitas del corazón,7,1,6
2015,4 años,"Accidente de vehículo de motor o sin motor, tipo de vehículo no especificado",7,6,1
2015,4 años,Otros trastornos del encéfalo,6,4,2
2015,4 años,Fiebre del dengue hemorrágico,5,2,3
2015,4 años,Epilepsia,5,3,2
2015,4 años,Otras sepsis,4,2,2
2015,4 años,Tumor maligno del ojo y sus anexos,4,2,2
2015,4 años,Leucemia de células de tipo no especificado,3,2,1
2015,4 años,Amiloidosis,3,1,2
2015,4 años,Obstrucción no especificada de la respiración,3,1,2
2015,4 años,"Parasitosis intestinal, sin otra especificación",2,1,1
2015,4 años,"Síntomas, signos y hallazgos anormales clínicos y de laboratorio, no clasificados en otra parte",16,6,10
2015,4 años,Otras causas,79,43,36
2015,5 - 9 años,"Neumonía, organismo no especificado",99,53,46
2015,5 - 9 años,Exposición a factores no especificados,77,55,22
2015,5 - 9 años,Otras gastroenteritis y colitis de origen infeccioso y no especificado,63,38,25
2015,5 - 9 años,"Accidente de vehículo de motor o sin motor, tipo de vehículo no especificado",30,26,4
2015,5 - 9 años,Ahogamiento y sumersión no especificados,19,15,4
2015,5 - 9 años,Otras sepsis,18,7,11
2015,5 - 9 años,Leucemia linfoide,17,11,6
2015,5 - 9 años,"Agresión con disparo de otras armas de fuego, y las no especificadas",12,6,6
2015,5 - 9 años,Ileo paralítico y obstrucción intestinal sin hernia,11,9,2
2015,5 - 9 años,Leucemia de células de tipo no especificado,9,6,3
2015,5 - 9 años,Epilepsia,9,6,3
2015,5 - 9 años,Parálisis cerebral,9,8,1
2015,5 - 9 años,Hidrocéfalo,9,3,6
2015,5 - 9 años,"Obstrucción de la respiración debida a hundimiento, caída de tierra u otras sustancias",9,7,2
2015,5 - 9 años,Otras enfermedades del sistema digestivo,8,2,6
2015,5 - 9 años,"Síntomas, signos y hallazgos anormales clínicos y de laboratorio, no clasificados en otra parte",83,38,45
2015,5 - 9 años,Otras causas,299,164,135
2015,10 - 14 años,Exposición a factores no especificados,72,53,19
2015,10 - 14 años,"Neumonía, organismo no especificado",70,39,31
2015,10 - 14 años,"Agresión con disparo de otras armas de fuego, y las no especificadas",58,40,18
2015,10 - 14 años,Otras gastroenteritis y colitis de origen infeccioso y no especificado,50,28,22
2015,10 - 14 años,"Accidente de vehículo de motor o sin motor, tipo de vehículo no especificado",43,32,11
2015,10 - 14 años,Ahogamiento y sumersión no especificados,30,25,5
2015,10 - 14 años,Otros estrangulamientos y ahorcamientos accidentales,26,11,15
2015,10 - 14 años,Enfermedad renal crónica,23,13,10
2015,10 - 14 años,Leucemia linfoide,22,10,12
2015,10 - 14 años,"Obstrucción de la respiración debida a hundimiento, caída de tierra u otras sustancias",17,8,9
2015,10 - 14 años,"Lesión autoinfligida intencionalmente por ahorcamiento, estrangulamiento o sofocación",17,10,7
2015,10 - 14 años,"Disparo de otras armas de fuego, y las no especificadas",15,11,4
2015,10 - 14 años,Otras sepsis,13,8,5
2015,10 - 14 años,Leucemia de células de tipo no especificado,11,8,3
2015,10 - 14 años,Neumocistosis,10,4,6
2015,10 - 14 años,"Síntomas, signos y hallazgos anormales clínicos y de laboratorio, no clasificados en otra parte",70,43,27
2015,10 - 14 años,Otras causas,328,166,162
2015,15 - 19 años,"Agresión con disparo de otras armas de fuego, y las no especificadas",513,439,74
2015,15 - 19 años,Exposición a factores no especificados,235,195,40
2015,15 - 19 años,"Disparo de otras armas de fuego, y las no especificadas",115,107,8
2015,15 - 19 años,"Accidente de vehículo de motor o sin motor, tipo de vehículo no especificado",111,95,16
2015,15 - 19 años,"Neumonía, organismo no especificado",57,33,24
2015,15 - 19 años,"Lesión autoinfligida intencionalmente por ahorcamiento, estrangulamiento o sofocación",57,30,27
2015,15 - 19 años,Otros estrangulamientos y ahorcamientos accidentales,52,36,16
2015,15 - 19 años,Agresión con objeto cortante,44,39,5
2015,15 - 19 años,Otras gastroenteritis y colitis de origen infeccioso y no especificado,42,26,16
2015,15 - 19 años,Ahogamiento y sumersión no especificados,37,31,6
2015,15 - 19 años,Enfermedad renal crónica,33,12,21
2015,15 - 19 años,Leucemia linfoide,28,16,12
2015,15 - 19 años,Infarto agudo del miocardio,27,13,14
2015,15 - 19 años,"Envenenamiento autoinfligido intencionalmente por, y exposición a otros productos químicos y sustancias nocivas, y los no especificados",27,11,16
2015,15 - 19 años,Agresión por medios no especificados,27,21,6
2015,15 - 19 años,"Síntomas, signos y hallazgos anormales clínicos y de laboratorio, no clasificados en otra parte",140,70,70
2015,15 - 19 años,Otras causas,808,418,390
2015,20 - 24 años,"Agresión con disparo de otras armas de fuego, y las no especificadas",673,613,60
2015,20 - 24 años,Exposición a factores no especificados,385,343,42
2015,20 - 24 años,"Accidente de vehículo de motor o sin motor, tipo de vehículo no especificado",179,159,20
2015,20 - 24 años,"Disparo de otras armas de fuego, y las no especificadas",148,136,12
2015,20 - 24 años,"Neumonía, organismo no especificado",75,51,24
2015,20 - 24 años,Agresión con objeto cortante,59,50,9
2015,20 - 24 años,Otros estrangulamientos y ahorcamientos accidentales,51,43,8
2015,20 - 24 años,Infarto agudo del miocardio,48,31,17
2015,20 - 24 años,Agresión por medios no especificados,47,45,2
2015,20 - 24 años,Ahogamiento y sumersión no especificados,43,40,3
2015,20 - 24 años,"Lesión autoinfligida intencionalmente por ahorcamiento, estrangulamiento o sofocación",41,35,6
2015,20 - 24 años,Otras gastroenteritis y colitis de origen infeccioso y no especificado,40,22,18
2015,20 - 24 años,Enfermedad renal crónica,35,15,20
2015,20 - 24 años,"Envenenamiento accidental por, y exposición al alcohol",34,31,3
2015,20 - 24 años,"Contacto traumático con cuchillo, espada, daga o puñal",26,25,1
2015,20 - 24 años,"Síntomas, signos y hallazgos anormales clínicos y de laboratorio, no clasificados en otra parte",138,83,55
2015,20 - 24 años,Otras causas,903,514,389
2015,25 - 29 años,"Agresión con disparo de otras armas de fuego, y las no especificadas",518,466,52
2015,25 - 29 años,Exposición a factores no especificados,275,250,25
2015,25 - 29 años,"Accidente de vehículo de motor o sin motor, tipo de vehículo no especificado",149,136,13
2015,25 - 29 años,"Disparo de otras armas de fuego, y las no especificadas",111,105,6
2015,25 - 29 años,"Neumonía, organismo no especificado",88,54,34
2015,25 - 29 años,Fibrosis y cirrosis del hígado,57,47,10
2015,25 - 29 años,Agresión con objeto cortante,54,48,6
2015,25 - 29 años,Agresión por medios no especificados,54,52,2
2015,25 - 29 años,Infarto agudo del miocardio,50,36,14
2015,25 - 29 años,Otros estrangulamientos y ahorcamientos accidentales,44,37,7
2015,25 - 29 años,Enfermedad alcohólica del hígado,37,31,6
2015,25 - 29 años,Otras gastroenteritis y colitis de origen infeccioso y no especificado,34,25,9
2015,25 - 29 años,"Envenenamiento accidental por, y exposición al alcohol",33,32,1
2015,25 - 29 años,Ahogamiento y sumersión no especificados,27,26,1
2015,25 - 29 años,"Lesión autoinfligida intencionalmente por ahorcamiento, estrangulamiento o sofocación",25,21,4
2015,25 - 29 años,"Síntomas, signos y hallazgos anormales clínicos y de laboratorio, no clasificados en otra parte",160,93,67
2015,25 - 29 años,Otras causas,900,495,405
2015,30 - 34 años,"Agresión con disparo de otras armas de fuego, y las no especificadas",403,358,45
2015,30 - 34 años,Exposición a factores no especificados,240,208,32
2015,30 - 34 años,"Accidente de vehículo de motor o sin motor, tipo de vehículo no especificado",146,129,17
2015,30 - 34 años,Fibrosis y cirrosis del hígado,104,86,18
2015,30 - 34 años,"Disparo de otras armas de fuego, y las no especificadas",103,90,13
2015,30 - 34 años,"Neumonía, organismo no especificado",86,56,30
2015,30 - 34 años,Enfermedad alcohólica del hígado,79,65,14
2015,30 - 34 años,Infarto agudo del miocardio,68,46,22
2015,30 - 34 años,"Diabetes mellitus, no especificada",60,30,30
2015,30 - 34 años,"Envenenamiento accidental por, y exposición al alcohol",59,52,7
2015,30 - 34 años,Trastornos mentales y del comportamiento debidos al uso de alcohol,49,46,3
2015,30 - 34 años,Agresión por medios no especificados,42,39,3
2015,30 - 34 años,Agresión con objeto cortante,40,32,8
2015,30 - 34 años,Otras gastroenteritis y colitis de origen infeccioso y no especificado,33,14,19
2015,30 - 34 años,"Síntomas, signos y hallazgos anormales clínicos y de laboratorio, no clasificados en otra parte",178,102,76
2015,30 - 34 años,Otras causas,106,578,482
2015,35 - 39 años,"Agresión con disparo de otras armas de fuego, y las no especificadas",345,308,37
2015,35 - 39 años,Exposición a factores no especificados,212,187,25
2015,35 - 39 años,Fibrosis y cirrosis del hígado,160,133,27
2015,35 - 39 años,"Neumonía, organismo no especificado",112,71,41
2015,35 - 39 años,"Accidente de vehículo de motor o sin motor, tipo de vehículo no especificado",109,83,26
2015,35 - 39 años,Enfermedad alcohólica del hígado,106,92,14
2015,35 - 39 años,"Diabetes mellitus, no especificada",92,54,38
2015,35 - 39 años,Infarto agudo del miocardio,92,55,37
2015,35 - 39 años,"Disparo de otras armas de fuego, y las no especificadas",82,71,11
2015,35 - 39 años,"Envenenamiento accidental por, y exposición al alcohol",82,74,8
2015,35 - 39 años,Trastornos mentales y del comportamiento debidos al uso de alcohol,73,70,3
2015,35 - 39 años,Tumor maligno del estómago,41,14,27
2015,35 - 39 años,"Enfermedad por virus de la inmunodeficiencia humana [VIH], sin otra especificación",40,26,14
2015,35 - 39 años,Otras gastroenteritis y colitis de origen infeccioso y no especificado,38,22,16
2015,35 - 39 años,Agresión con objeto cortante,37,33,4
2015,35 - 39 años,"Síntomas, signos y hallazgos anormales clínicos y de laboratorio, no clasificados en otra parte",177,103,74
2015,35 - 39 años,Otras causas,128,707,573
2015,40 - 44 años,"Agresión con disparo de otras armas de fuego, y las no especificadas",246,215,31
2015,40 - 44 años,Fibrosis y cirrosis del hígado,207,176,31
2015,40 - 44 años,Exposición a factores no especificados,170,142,28
2015,40 - 44 años,"Diabetes mellitus, no especificada",159,86,73
2015,40 - 44 años,Enfermedad alcohólica del hígado,118,103,15
2015,40 - 44 años,Infarto agudo del miocardio,99,58,41
2015,40 - 44 años,"Neumonía, organismo no especificado",85,48,37
2015,40 - 44 años,"Envenenamiento accidental por, y exposición al alcohol",81,73,8
2015,40 - 44 años,Trastornos mentales y del comportamiento debidos al uso de alcohol,74,70,4
2015,40 - 44 años,"Accidente de vehículo de motor o sin motor, tipo de vehículo no especificado",69,62,7
2015,40 - 44 años,"Disparo de otras armas de fuego, y las no especificadas",60,48,12
2015,40 - 44 años,Enfermedad renal crónica,57,39,18
2015,40 - 44 años,Tumor maligno del hígado y de las vías biliares intrahepáticas,54,27,27
2015,40 - 44 años,Tumor maligno del estómago,53,29,24
2015,40 - 44 años,Otras gastroenteritis y colitis de origen infeccioso y no especificado,49,28,21
2015,40 - 44 años,"Síntomas, signos y hallazgos anormales clínicos y de laboratorio, no clasificados en otra parte",192,114,78
2015,40 - 44 años,Otras causas,1169,644,525
2015,45 - 49 años,"Diabetes mellitus, no especificada",232,104,128
2015,45 - 49 años,Fibrosis y cirrosis del hígado,201,153,48
2015,45 - 49 años,Exposición a factores no especificados,175,144,31
2015,45 - 49 años,Infarto agudo del miocardio,164,114,50
2015,45 - 49 años,"Agresión con disparo de otras armas de fuego, y las no especificadas",159,134,25
2015,45 - 49 años,Enfermedad alcohólica del hígado,111,89,22
2015,45 - 49 años,"Neumonía, organismo no especificado",109,59,50
2015,45 - 49 años,Diabetes mellitus no insulinodependiente,91,39,52
2015,45 - 49 años,Trastornos mentales y del comportamiento debidos al uso de alcohol,69,58,11
2015,45 - 49 años,"Accidente de vehículo de motor o sin motor, tipo de vehículo no especificado",65,53,12
2015,45 - 49 años,Enfermedad renal crónica,64,40,24
2015,45 - 49 años,"Envenenamiento accidental por, y exposición al alcohol",61,56,5
2015,45 - 49 años,Tumor maligno del hígado y de las vías biliares intrahepáticas,55,21,34
2015,45 - 49 años,Tumor maligno del estómago,53,15,38
2015,45 - 49 años,Otras gastroenteritis y colitis de origen infeccioso y no especificado,49,27,22
2015,45 - 49 años,"Síntomas, signos y hallazgos anormales clínicos y de laboratorio, no clasificados en otra parte",200,107,93
2015,45 - 49 años,Otras causas,128,672,608
2015,50 - 54 años,"Diabetes mellitus, no especificada",339,134,205
2015,50 - 54 años,Fibrosis y cirrosis del hígado,249,185,64
2015,50 - 54 años,Infarto agudo del miocardio,215,110,105
2015,50 - 54 años,Exposición a factores no especificados,179,153,26
2015,50 - 54 años,"Neumonía, organismo no especificado",151,89,62
2015,50 - 54 años,Diabetes mellitus no insulinodependiente,126,62,64
2015,50 - 54 años,"Agresión con disparo de otras armas de fuego, y las no especificadas",117,97,20
2015,50 - 54 años,Enfermedad alcohólica del hígado,108,91,17
2015,50 - 54 años,Tumor maligno del estómago,92,40,52
2015,50 - 54 años,Tumor maligno del hígado y de las vías biliares intrahepáticas,87,39,48
2015,50 - 54 años,Enfermedad renal crónica,87,53,34
2015,50 - 54 años,"Envenenamiento accidental por, y exposición al alcohol",64,59,5
2015,50 - 54 años,Trastornos mentales y del comportamiento debidos al uso de alcohol,62,60,2
2015,50 - 54 años,"Accidente de vehículo de motor o sin motor, tipo de vehículo no especificado",54,44,10
2015,50 - 54 años,Otras gastroenteritis y colitis de origen infeccioso y no especificado,48,23,25
2015,50 - 54 años,"Síntomas, signos y hallazgos anormales clínicos y de laboratorio, no clasificados en otra parte",264,165,99
2015,50 - 54 años,Otras causas,1483,753,730
2015,55 - 59 años,"Diabetes mellitus, no especificada",492,193,299
2015,55 - 59 años,Infarto agudo del miocardio,292,163,129
2015,55 - 59 años,Fibrosis y cirrosis del hígado,256,164,92
2015,55 - 59 años,"Neumonía, organismo no especificado",177,91,86
2015,55 - 59 años,Diabetes mellitus no insulinodependiente,166,75,91
2015,55 - 59 años,Exposición a factores no especificados,155,130,25
2015,55 - 59 años,Tumor maligno del hígado y de las vías biliares intrahepáticas,127,63,64
2015,55 - 59 años,Enfermedad renal crónica,119,56,63
2015,55 - 59 años,Tumor maligno del estómago,118,65,53
2015,55 - 59 años,Enfermedad alcohólica del hígado,91,75,16
2015,55 - 59 años,"Agresión con disparo de otras armas de fuego, y las no especificadas",78,70,8
2015,55 - 59 años,"Accidente vascular encefálico agudo, no especificado como hemorrágico o isquémico",68,38,30
2015,55 - 59 años,Insuficiencia cardíaca,57,19,38
2015,55 - 59 años,"Accidente de vehículo de motor o sin motor, tipo de vehículo no especificado",53,47,6
2015,55 - 59 años,Otras gastroenteritis y colitis de origen infeccioso y no especificado,52,24,28
2015,55 - 59 años,"Síntomas, signos y hallazgos anormales clínicos y de laboratorio, no clasificados en otra parte",295,159,136
2015,55 - 59 años,Otras causas,1726,887,839
2015,60 - 64 años,"Diabetes mellitus, no especificada",532,205,327
2015,60 - 64 años,Infarto agudo del miocardio,402,230,172
2015,60 - 64 años,Fibrosis y cirrosis del hígado,298,173,125
2015,60 - 64 años,"Neumonía, organismo no especificado",235,123,112
2015,60 - 64 años,Diabetes mellitus no insulinodependiente,231,98,133
2015,60 - 64 años,Tumor maligno del hígado y de las vías biliares intrahepáticas,186,96,90
2015,60 - 64 años,Enfermedad renal crónica,158,93,65
2015,60 - 64 años,Exposición a factores no especificados,143,116,27
2015,60 - 64 años,Tumor maligno del estómago,138,69,69
2015,60 - 64 años,"Accidente vascular encefálico agudo, no especificado como hemorrágico o isquémico",96,50,46
2015,60 - 64 años,Enfermedad renal crónica,96,43,53
2015,60 - 64 años,Otras gastroenteritis y colitis de origen infeccioso y no especificado,77,25,52
2015,60 - 64 años,Insuficiencia cardíaca,75,35,40
2015,60 - 64 años,Enfermedad alcohólica del hígado,68,53,15
2015,60 - 64 años,"Envenenamiento accidental por, y exposición al alcohol",61,58,3
2015,60 - 64 años,"Síntomas, signos y hallazgos anormales clínicos y de laboratorio, no clasificados en otra parte",349,169,180
2015,60 - 64 años,Otras causas,1909,921,988
2015,65 - 69 años,"Diabetes mellitus, no especificada",585,233,352
2015,65 - 69 años,Infarto agudo del miocardio,472,279,193
2015,65 - 69 años,"Neumonía, organismo no especificado",307,155,152
2015,65 - 69 años,Fibrosis y cirrosis del hígado,274,145,129
2015,65 - 69 años,Diabetes mellitus no insulinodependiente,216,94,122
2015,65 - 69 años,Tumor maligno del hígado y de las vías biliares intrahepáticas,184,88,96
2015,65 - 69 años,Tumor maligno del estómago,158,80,78
2015,65 - 69 años,Enfermedad renal crónica,147,73,74
2015,65 - 69 años,"Accidente vascular encefálico agudo, no especificado como hemorrágico o isquémico",146,79,67
2015,65 - 69 años,Exposición a factores no especificados,134,107,27
2015,65 - 69 años,Insuficiencia cardíaca,113,50,63
2015,65 - 69 años,Otras gastroenteritis y colitis de origen infeccioso y no especificado,93,38,55
2015,65 - 69 años,Otras enfermedades pulmonares obstructivas crónicas,81,48,33
2015,65 - 69 años,Enfermedad renal crónica,79,47,32
2015,65 - 69 años,Otras enfermedades cerebrovasculares,70,35,35
2015,65 - 69 años,"Síntomas, signos y hallazgos anormales clínicos y de laboratorio, no clasificados en otra parte",446,238,208
2015,65 - 69 años,Otras causas,1986,1085,901
2015,70 - 74 años,Infarto agudo del miocardio,540,278,262
2015,70 - 74 años,"Diabetes mellitus, no especificada",501,210,291
2015,70 - 74 años,"Neumonía, organismo no especificado",422,237,185
2015,70 - 74 años,Fibrosis y cirrosis del hígado,197,107,90
2015,70 - 74 años,Diabetes mellitus no insulinodependiente,185,81,104
2015,70 - 74 años,Tumor maligno del hígado y de las vías biliares intrahepáticas,181,79,102
2015,70 - 74 años,"Accidente vascular encefálico agudo, no especificado como hemorrágico o isquémico",175,88,87
2015,70 - 74 años,Tumor maligno del estómago,162,78,84
2015,70 - 74 años,Enfermedad renal crónica,138,77,61
2015,70 - 74 años,Insuficiencia cardíaca,130,75,55
2015,70 - 74 años,Exposición a factores no especificados,114,89,25
2015,70 - 74 años,Enfermedad renal crónica,102,52,50
2015,70 - 74 años,Otras gastroenteritis y colitis de origen infeccioso y no especificado,98,44,54
2015,70 - 74 años,Hipertensión esencial (primaria),80,41,39
2015,70 - 74 años,"Síntomas, signos y hallazgos anormales clínicos y de laboratorio, no clasificados en otra parte",480,243,237
2015,70 - 74 años,Otras causas,1974,1004,970
2015,75 - 79 años,Infarto agudo del miocardio,653,347,306
2015,75 - 79 años,"Neumonía, organismo no especificado",615,311,304
2015,75 - 79 años,"Diabetes mellitus, no especificada",505,190,315
2015,75 - 79 años,"Accidente vascular encefálico agudo, no especificado como hemorrágico o isquémico",271,132,139
2015,75 - 79 años,Diabetes mellitus no insulinodependiente,189,75,114
2015,75 - 79 años,Tumor maligno del estómago,183,90,93
2015,75 - 79 años,Tumor maligno del hígado y de las vías biliares intrahepáticas,183,87,96
2015,75 - 79 años,Insuficiencia cardíaca,172,86,86
2015,75 - 79 años,Fibrosis y cirrosis del hígado,158,72,86
2015,75 - 79 años,Enfermedad renal crónica,148,81,67
2015,75 - 79 años,Otras enfermedades pulmonares obstructivas crónicas,120,62,58
2015,75 - 79 años,Otras gastroenteritis y colitis de origen infeccioso y no especificado,115,61,54
2015,75 - 79 años,Otras enfermedades cerebrovasculares,105,51,54
2015,75 - 79 años,Enfermedad renal crónica,104,59,45
2015,75 - 79 años,"Síntomas, signos y hallazgos anormales clínicos y de laboratorio, no clasificados en otra parte",683,333,350
2015,75 - 79 años,Otras causas,214,111,103
2015,80 - 84 años,Infarto agudo del miocardio,786,388,398
2015,80 - 84 años,"Neumonía, organismo no especificado",773,417,356
2015,80 - 84 años,"Diabetes mellitus, no especificada",365,136,229
2015,80 - 84 años,"Accidente vascular encefálico agudo, no especificado como hemorrágico o isquémico",343,158,185
2015,80 - 84 años,Insuficiencia cardíaca,255,123,132
2015,80 - 84 años,Otras enfermedades pulmonares obstructivas crónicas,168,98,70
2015,80 - 84 años,Diabetes mellitus no insulinodependiente,155,56,99
2015,80 - 84 años,Tumor maligno del estómago,134,63,71
2015,80 - 84 años,Otras gastroenteritis y colitis de origen infeccioso y no especificado,130,69,61
2015,80 - 84 años,"Desnutrición proteicocalórica, no especificada",129,67,62
2015,80 - 84 años,Tumor maligno del hígado y de las vías biliares intrahepáticas,124,53,71
2015,80 - 84 años,Otras enfermedades cerebrovasculares,122,60,62
2015,80 - 84 años,Hipertensión esencial (primaria),121,55,66
2015,80 - 84 años,Enfermedad renal crónica,120,60,60
2015,80 - 84 años,Enfermedad renal crónica,117,72,45
2015,80 - 84 años,"Síntomas, signos y hallazgos anormales clínicos y de laboratorio, no clasificados en otra parte",875,419,456
2015,80 - 84 años,Otras causas,2153,1162,991
2015,85 y más,Infarto agudo del miocardio,1628,778,850
2015,85 y más,"Neumonía, organismo no especificado",1507,774,733
2015,85 y más,Insuficiencia cardíaca,469,205,264
2015,85 y más,"Accidente vascular encefálico agudo, no especificado como hemorrágico o isquémico",449,207,242
2015,85 y más,"Diabetes mellitus, no especificada",359,147,212
2015,85 y más,"Desnutrición proteicocalórica, no especificada",358,154,204
2015,85 y más,Otras enfermedades pulmonares obstructivas crónicas,254,132,122
2015,85 y más,Hipertensión esencial (primaria),214,85,129
2015,85 y más,Otras gastroenteritis y colitis de origen infeccioso y no especificado,171,83,88
2015,85 y más,Otras enfermedades cerebrovasculares,156,79,77
2015,85 y más,Tumor maligno del estómago,153,74,79
2015,85 y más,Enfermedad renal crónica,141,70,71
2015,85 y más,Exposición a factores no especificados,141,75,66
2015,85 y más,Enfermedad renal crónica,133,78,55
2015,85 y más,"Síntomas, signos y hallazgos anormales clínicos y de laboratorio, no clasificados en otra parte",1793,837,956
2015,85 y más,Otras causas,2626,1189,1437
2016,1- 6 días,Dificultad respiratoria del recién nacido,465,295,170
2016,1- 6 días,Sepsis bacteriana del recién nacido,219,129,90
2016,1- 6 días,Neumonía congénita,178,116,62
2016,1- 6 días,Trastornos cardiovasculares originados en el período perinatal,145,84,61
2016,1- 6 días,Asfixia del nacimiento,138,85,53
2016,1- 6 días,Síndromes de aspiración neonatal,133,58,75
2016,1- 6 días,"Otras malformaciones congénitas, no clasificadas en otra parte",125,63,62
2016,1- 6 días,"Trastornos relacionados con duración corta de la gestación y con bajo peso al nacer, no clasificados en otra parte",115,67,48
2016,1- 6 días,Otras malformaciones congénitas del corazón,61,37,24
2016,1- 6 días,Hemorragia pulmonar originada en el período perinatal,47,29,18
2016,1- 6 días,"Enfisema intersticial y afecciones relacionadas, originadas en el período perinatal",35,21,14
2016,1- 6 días,Coagulación intravascular diseminada en el feto y el recién nacido,31,18,13
2016,1- 6 días,"Otros problemas respiratorios del recién nacido, originados en el período perinatal",30,16,14
2016,1- 6 días,Anencefalia y malformaciones congénitas similares,28,8,20
2016,1- 6 días,Otras hemorragias neonatales,26,16,10
2016,1- 6 días,"Síntomas, signos y hallazgos anormales clínicos y de laboratorio, no clasificados en otra parte",99,65,34
2016,1- 6 días,Otras causas,342,197,145
2016,7 - 27 días,Neumonía congénita,255,143,112
2016,7 - 27 días,Sepsis bacteriana del recién nacido,211,103,108
2016,7 - 27 días,Dificultad respiratoria del recién nacido,134,81,53
2016,7 - 27 días,Enterocolitis necrotizante del feto y del recién nacido,66,40,26
2016,7 - 27 días,Trastornos cardiovasculares originados en el período perinatal,57,27,30
2016,7 - 27 días,Otras malformaciones congénitas del corazón,54,30,24
2016,7 - 27 días,"Trastornos relacionados con duración corta de la gestación y con bajo peso al nacer, no clasificados en otra parte",52,34,18
2016,7 - 27 días,Coagulación intravascular diseminada en el feto y el recién nacido,43,25,18
2016,7 - 27 días,Hemorragia pulmonar originada en el período perinatal,39,25,14
2016,7 - 27 días,"Otras malformaciones congénitas, no clasificadas en otra parte",36,23,13
2016,7 - 27 días,Otras hemorragias neonatales,35,20,15
2016,7 - 27 días,Asfixia del nacimiento,32,22,10
2016,7 - 27 días,Síndromes de aspiración neonatal,31,13,18
2016,7 - 27 días,"Otros problemas respiratorios del recién nacido, originados en el período perinatal",25,18,7
2016,7 - 27 días,Hemorragia intracraneal no traumática del feto y del recién nacido,23,17,6
2016,7 - 27 días,"Síntomas, signos y hallazgos anormales clínicos y de laboratorio, no clasificados en otra parte",97,53,44
2016,7 - 27 días,Otras causas,296,173,123
2016,28 días a menos de 1 año,"Neumonía, organismo no especificado",122,691,529
2016,28 días a menos de 1 año,Otras gastroenteritis y colitis de origen infeccioso y no especificado,475,281,194
2016,28 días a menos de 1 año,Otras malformaciones congénitas del corazón,191,106,85
2016,28 días a menos de 1 año,Otras sepsis,184,101,83
2016,28 días a menos de 1 año,Coagulación intravascular diseminada [síndrome de desfibrinación],66,39,27
2016,28 días a menos de 1 año,"Neumonía bacteriana, no clasificada en otra parte",66,32,34
2016,28 días a menos de 1 año,Otros trastornos respiratorios,62,41,21
2016,28 días a menos de 1 año,"Desnutrición proteicocalórica severa, no especificada",61,32,29
2016,28 días a menos de 1 año,"Desnutrición proteicocalórica, no especificada",51,32,19
2016,28 días a menos de 1 año,"Otros trastornos de los líquidos, de los electrólitos y del equilibrio ácido-básico",49,33,16
2016,28 días a menos de 1 año,Depleción del volumen,47,26,21
2016,28 días a menos de 1 año,Síndrome de dificultad respiratoria del adulto,47,24,23
2016,28 días a menos de 1 año,"Otras malformaciones congénitas, no clasificadas en otra parte",44,21,23
2016,28 días a menos de 1 año,Síndrome de Down,42,24,18
2016,28 días a menos de 1 año,Obstrucción no especificada de la respiración,38,15,23
2016,28 días a menos de 1 año,"Síntomas, signos y hallazgos anormales clínicos y de laboratorio, no clasificados en otra parte",566,307,259
2016,28 días a menos de 1 año,Otras causas,1033,573,460
2016,1 año,"Neumonía, organismo no especificado",376,190,186
2016,1 año,Otras gastroenteritis y colitis de origen infeccioso y no especificado,351,208,143
2016,1 año,Otras sepsis,42,19,23
2016,1 año,"Desnutrición proteicocalórica severa, no especificada",38,17,21
2016,1 año,"Otros trastornos de los líquidos, de los electrólitos y del equilibrio ácido-básico",37,19,18
2016,1 año,"Desnutrición proteicocalórica, no especificada",33,17,16
2016,1 año,Depleción del volumen,29,15,14
2016,1 año,Otros trastornos respiratorios,19,8,11
2016,1 año,Exposición a factores no especificados,19,10,9
2016,1 año,Otras enfermedades del sistema digestivo,17,10,7
2016,1 año,Otras malformaciones congénitas del corazón,16,6,10
2016,1 año,Coagulación intravascular diseminada [síndrome de desfibrinación],14,5,9
2016,1 año,Hidrocéfalo,14,8,6
2016,1 año,Obstrucción no especificada de la respiración,14,6,8
2016,1 año,Otras anemias,13,4,9
2016,1 año,"Síntomas, signos y hallazgos anormales clínicos y de laboratorio, no clasificados en otra parte",195,110,85
2016,1 año,Otras causas,361,186,175
2016,2 años,"Neumonía, organismo no especificado",115,62,53
2016,2 años,Otras gastroenteritis y colitis de origen infeccioso y no especificado,98,53,45
2016,2 años,Otras malformaciones congénitas del corazón,17,12,5
2016,2 años,Otras sepsis,14,6,8
2016,2 años,Exposición a factores no especificados,12,7,5
2016,2 años,"Desnutrición proteicocalórica severa, no especificada",11,7,4
2016,2 años,"Desnutrición proteicocalórica, no especificada",11,4,7
2016,2 años,Hidrocéfalo,9,3,6
2016,2 años,Síndrome de Down,9,7,2
2016,2 años,Otras infecciones intestinales bacterianas,8,3,5
2016,2 años,"Otros trastornos de los líquidos, de los electrólitos y del equilibrio ácido-básico",8,7,1
2016,2 años,Ahogamiento y sumersión no especificados,8,6,2
2016,2 años,"Exposición a humos, fuegos o llamas no especificados",7,4,3
2016,2 años,"Neumonía bacteriana, no clasificada en otra parte",5,2,3
2016,2 años,"Síntomas, signos y hallazgos anormales clínicos y de laboratorio, no clasificados en otra parte",75,37,38
2016,2 años,Otras causas,152,74,78
2016,3 años,"Neumonía, organismo no especificado",49,25,24
2016,3 años,Otras gastroenteritis y colitis de origen infeccioso y no especificado,46,22,24
2016,3 años,Exposición a factores no especificados,9,8,1
2016,3 años,Otras sepsis,8,4,4
2016,3 años,"Accidente de vehículo de motor o sin motor, tipo de vehículo no especificado",8,5,3
2016,3 años,Epilepsia,7,4,3
2016,3 años,Depleción del volumen,6,4,2
2016,3 años,Ahogamiento y sumersión no especificados,6,5,1
2016,3 años,Parálisis cerebral,5,3,2
2016,3 años,Otros trastornos del encéfalo,5,4,1
2016,3 años,"Otras malformaciones congénitas, no clasificadas en otra parte",5,3,2
2016,3 años,"Exposición a humos, fuegos o llamas no especificados",5,2,3
2016,3 años,Obstrucción no especificada de la respiración,4,3,1
2016,3 años,Coagulación intravascular diseminada [síndrome de desfibrinación],3,1,2
2016,3 años,"Síntomas, signos y hallazgos anormales clínicos y de laboratorio, no clasificados en otra parte",40,27,13
2016,3 años,Otras causas,82,49,33
2016,4 años,"Neumonía, organismo no especificado",37,12,25
2016,4 años,Otras gastroenteritis y colitis de origen infeccioso y no especificado,31,12,19
2016,4 años,Exposición a factores no especificados,12,10,2
2016,4 años,Otras sepsis,7,4,3
2016,4 años,Leucemia linfoide,7,4,3
2016,4 años,"Desnutrición proteicocalórica, no especificada",6,2,4
2016,4 años,Otras malformaciones congénitas del corazón,5,2,3
2016,4 años,"Desnutrición proteicocalórica severa, no especificada",4,2,2
2016,4 años,Parálisis cerebral,4,2,2
2016,4 años,"Neumonía bacteriana, no clasificada en otra parte",4,1,3
2016,4 años,"Accidente de vehículo de motor o sin motor, tipo de vehículo no especificado",4,3,1
2016,4 años,Otras anemias,3,2,1
2016,4 años,Otros síndromes paralíticos,3,1,2
2016,4 años,Hidrocéfalo,3,1,2
2016,4 años,"Síntomas, signos y hallazgos anormales clínicos y de laboratorio, no clasificados en otra parte",17,6,11
2016,4 años,Otras causas,65,38,27
2016,5 - 9 años,"Neumonía, organismo no especificado",94,42,52
2016,5 - 9 años,Otras gastroenteritis y colitis de origen infeccioso y no especificado,54,29,25
2016,5 - 9 años,Exposición a factores no especificados,52,37,15
2016,5 - 9 años,"Accidente de vehículo de motor o sin motor, tipo de vehículo no especificado",25,14,11
2016,5 - 9 años,Leucemia linfoide,17,13,4
2016,5 - 9 años,Epilepsia,16,6,10
2016,5 - 9 años,Otras sepsis,14,9,5
2016,5 - 9 años,Otros síndromes paralíticos,13,7,6
2016,5 - 9 años,Leucemia de células de tipo no especificado,12,7,5
2016,5 - 9 años,Parálisis cerebral,12,6,6
2016,5 - 9 años,Ahogamiento y sumersión no especificados,11,9,2
2016,5 - 9 años,Otras malformaciones congénitas del corazón,10,6,4
2016,5 - 9 años,Obstrucción no especificada de la respiración,9,7,2
2016,5 - 9 años,Tumor de comportamiento incierto o desconocido del encéfalo y del sistema nervioso central,8,3,5
2016,5 - 9 años,Hidrocéfalo,8,4,4
2016,5 - 9 años,"Síntomas, signos y hallazgos anormales clínicos y de laboratorio, no clasificados en otra parte",81,45,36
2016,5 - 9 años,Otras causas,258,144,114
2016,10 - 14 años,Exposición a factores no especificados,68,51,17
2016,10 - 14 años,"Neumonía, organismo no especificado",53,32,21
2016,10 - 14 años,"Agresión con disparo de otras armas de fuego, y las no especificadas",40,31,9
2016,10 - 14 años,Otras gastroenteritis y colitis de origen infeccioso y no especificado,39,19,20
2016,10 - 14 años,"Accidente de vehículo de motor o sin motor, tipo de vehículo no especificado",33,23,10
2016,10 - 14 años,Epilepsia,22,13,9
2016,10 - 14 años,Ahogamiento y sumersión no especificados,21,19,2
2016,10 - 14 años,Otras sepsis,20,8,12
2016,10 - 14 años,Complicaciones y descripciones mal definidas de enfermedad cardíaca,19,10,9
2016,10 - 14 años,Leucemia linfoide,18,11,7
2016,10 - 14 años,"Disparo de otras armas de fuego, y las no especificadas",17,12,5
2016,10 - 14 años,"Lesión autoinfligida intencionalmente por ahorcamiento, estrangulamiento o sofocación",15,8,7
2016,10 - 14 años,Enfermedad renal crónica,14,6,8
2016,10 - 14 años,Otras anemias,13,8,5
2016,10 - 14 años,Otros estrangulamientos y ahorcamientos accidentales,12,7,5
2016,10 - 14 años,"Síntomas, signos y hallazgos anormales clínicos y de laboratorio, no clasificados en otra parte",90,38,52
2016,10 - 14 años,Otras causas,354,181,173
2016,15 - 19 años,"Agresión con disparo de otras armas de fuego, y las no especificadas",536,463,73
2016,15 - 19 años,Exposición a factores no especificados,205,175,30
2016,15 - 19 años,"Accidente de vehículo de motor o sin motor, tipo de vehículo no especificado",144,117,27
2016,15 - 19 años,"Disparo de otras armas de fuego, y las no especificadas",104,94,10
2016,15 - 19 años,"Neumonía, organismo no especificado",87,43,44
2016,15 - 19 años,Otros estrangulamientos y ahorcamientos accidentales,61,46,15
2016,15 - 19 años,Ahogamiento y sumersión no especificados,57,41,16
2016,15 - 19 años,"Lesión autoinfligida intencionalmente por ahorcamiento, estrangulamiento o sofocación",44,28,16
2016,15 - 19 años,Agresión con objeto cortante,44,30,14
2016,15 - 19 años,Enfermedad renal crónica,41,18,23
2016,15 - 19 años,Otras gastroenteritis y colitis de origen infeccioso y no especificado,39,27,12
2016,15 - 19 años,Agresión por medios no especificados,32,25,7
2016,15 - 19 años,"Envenenamiento accidental por, y exposición a otros productos químicos y sustancias nocivas, y los no especificados",31,15,16
2016,15 - 19 años,"Agresión por ahorcamiento, estrangulamiento y sofocación",30,19,11
2016,15 - 19 años,Epilepsia,25,13,12
2016,15 - 19 años,"Síntomas, signos y hallazgos anormales clínicos y de laboratorio, no clasificados en otra parte",115,72,43
2016,15 - 19 años,Otras causas,767,390,377
2016,20 - 24 años,"Agresión con disparo de otras armas de fuego, y las no especificadas",631,560,71
2016,20 - 24 años,Exposición a factores no especificados,349,319,30
2016,20 - 24 años,"Accidente de vehículo de motor o sin motor, tipo de vehículo no especificado",279,243,36
2016,20 - 24 años,"Disparo de otras armas de fuego, y las no especificadas",119,109,10
2016,20 - 24 años,"Neumonía, organismo no especificado",72,43,29
2016,20 - 24 años,Agresión con objeto cortante,58,51,7
2016,20 - 24 años,Agresión por medios no especificados,55,49,6
2016,20 - 24 años,Ahogamiento y sumersión no especificados,51,48,3
2016,20 - 24 años,Infarto agudo del miocardio,47,32,15
2016,20 - 24 años,Otros estrangulamientos y ahorcamientos accidentales,47,38,9
2016,20 - 24 años,Otras gastroenteritis y colitis de origen infeccioso y no especificado,44,23,21
2016,20 - 24 años,Enfermedad renal crónica,44,23,21
2016,20 - 24 años,"Lesión autoinfligida intencionalmente por ahorcamiento, estrangulamiento o sofocación",41,38,3
2016,20 - 24 años,"Envenenamiento accidental por, y exposición a otros productos químicos y sustancias nocivas, y los no especificados",39,29,10
2016,20 - 24 años,"Agresión por ahorcamiento, estrangulamiento y sofocación",34,19,15
2016,20 - 24 años,"Síntomas, signos y hallazgos anormales clínicos y de laboratorio, no clasificados en otra parte",149,84,65
2016,20 - 24 años,Otras causas,888,513,375
2016,25 - 29 años,"Agresión con disparo de otras armas de fuego, y las no especificadas",437,394,43
2016,25 - 29 años,Exposición a factores no especificados,309,274,35
2016,25 - 29 años,"Accidente de vehículo de motor o sin motor, tipo de vehículo no especificado",220,194,26
2016,25 - 29 años,"Disparo de otras armas de fuego, y las no especificadas",100,89,11
2016,25 - 29 años,"Neumonía, organismo no especificado",82,56,26
2016,25 - 29 años,Infarto agudo del miocardio,62,44,18
2016,25 - 29 años,Fibrosis y cirrosis del hígado,54,47,7
2016,25 - 29 años,Agresión por medios no especificados,48,44,4
2016,25 - 29 años,Otras gastroenteritis y colitis de origen infeccioso y no especificado,47,30,17
2016,25 - 29 años,Agresión con objeto cortante,43,34,9
2016,25 - 29 años,Enfermedad alcohólica del hígado,40,35,5
2016,25 - 29 años,"Envenenamiento accidental por, y exposición al alcohol",40,39,1
2016,25 - 29 años,Otros estrangulamientos y ahorcamientos accidentales,37,33,4
2016,25 - 29 años,Enfermedad renal crónica,31,23,8
2016,25 - 29 años,"Lesión autoinfligida intencionalmente por ahorcamiento, estrangulamiento o sofocación",31,27,4
2016,25 - 29 años,"Síntomas, signos y hallazgos anormales clínicos y de laboratorio, no clasificados en otra parte",165,92,73
2016,25 - 29 años,Otras causas,953,554,399
2016,30 - 34 años,"Agresión con disparo de otras armas de fuego, y las no especificadas",413,371,42
2016,30 - 34 años,Exposición a factores no especificados,237,212,25
2016,30 - 34 años,"Accidente de vehículo de motor o sin motor, tipo de vehículo no especificado",135,120,15
2016,30 - 34 años,Fibrosis y cirrosis del hígado,99,87,12
2016,30 - 34 años,"Disparo de otras armas de fuego, y las no especificadas",97,90,7
2016,30 - 34 años,"Neumonía, organismo no especificado",81,54,27
2016,30 - 34 años,Infarto agudo del miocardio,80,50,30
2016,30 - 34 años,"Envenenamiento accidental por, y exposición al alcohol",71,69,2
2016,30 - 34 años,Enfermedad alcohólica del hígado,66,57,9
2016,30 - 34 años,"Diabetes mellitus, no especificada",50,29,21
2016,30 - 34 años,Otras gastroenteritis y colitis de origen infeccioso y no especificado,44,28,16
2016,30 - 34 años,Trastornos mentales y del comportamiento debidos al uso de alcohol,40,37,3
2016,30 - 34 años,"Enfermedad por virus de la inmunodeficiencia humana [VIH], resultante en enfermedades infecciosas y parasitarias",39,28,11
2016,30 - 34 años,Agresión con objeto cortante,39,34,5
2016,30 - 34 años,Agresión por medios no especificados,37,33,4
2016,30 - 34 años,"Síntomas, signos y hallazgos anormales clínicos y de laboratorio, no clasificados en otra parte",169,100,69
2016,30 - 34 años,Otras causas,1042,567,475
2016,35 - 39 años,"Agresión con disparo de otras armas de fuego, y las no especificadas",368,323,45
2016,35 - 39 años,Exposición a factores no especificados,214,186,28
2016,35 - 39 años,Fibrosis y cirrosis del hígado,182,142,40
2016,35 - 39 años,"Accidente de vehículo de motor o sin motor, tipo de vehículo no especificado",122,103,19
2016,35 - 39 años,"Diabetes mellitus, no especificada",114,60,54
2016,35 - 39 años,Infarto agudo del miocardio,96,64,32
2016,35 - 39 años,"Neumonía, organismo no especificado",93,59,34
2016,35 - 39 años,Enfermedad alcohólica del hígado,81,70,11
2016,35 - 39 años,"Envenenamiento accidental por, y exposición al alcohol",79,76,3
2016,35 - 39 años,"Disparo de otras armas de fuego, y las no especificadas",65,56,9
2016,35 - 39 años,Otras gastroenteritis y colitis de origen infeccioso y no especificado,42,25,17
2016,35 - 39 años,Trastornos mentales y del comportamiento debidos al uso de alcohol,40,35,5
2016,35 - 39 años,Tumor maligno del estómago,38,17,21
2016,35 - 39 años,Agresión con objeto cortante,38,32,6
2016,35 - 39 años,Enfermedad renal crónica,36,20,16
2016,35 - 39 años,"Síntomas, signos y hallazgos anormales clínicos y de laboratorio, no clasificados en otra parte",235,143,92
2016,35 - 39 años,Otras causas,1194,671,523
2016,40 - 44 años,"Agresión con disparo de otras armas de fuego, y las no especificadas",218,191,27
2016,40 - 44 años,Fibrosis y cirrosis del hígado,209,155,54
2016,40 - 44 años,Exposición a factores no especificados,193,167,26
2016,40 - 44 años,"Diabetes mellitus, no especificada",151,67,84
2016,40 - 44 años,Enfermedad alcohólica del hígado,114,94,20
2016,40 - 44 años,"Neumonía, organismo no especificado",113,66,47
2016,40 - 44 años,Infarto agudo del miocardio,111,72,39
2016,40 - 44 años,"Accidente de vehículo de motor o sin motor, tipo de vehículo no especificado",100,88,12
2016,40 - 44 años,"Envenenamiento accidental por, y exposición al alcohol",77,69,8
2016,40 - 44 años,"Disparo de otras armas de fuego, y las no especificadas",65,58,7
2016,40 - 44 años,Enfermedad renal crónica,58,34,24
2016,40 - 44 años,Trastornos mentales y del comportamiento debidos al uso de alcohol,55,50,5
2016,40 - 44 años,Otras gastroenteritis y colitis de origen infeccioso y no especificado,45,26,19
2016,40 - 44 años,Tumor maligno del estómago,45,19,26
2016,40 - 44 años,Diabetes mellitus no insulinodependiente,42,19,23
2016,40 - 44 años,"Síntomas, signos y hallazgos anormales clínicos y de laboratorio, no clasificados en otra parte",221,133,88
2016,40 - 44 años,Otras causas,1165,636,529
2016,45 - 49 años,"Diabetes mellitus, no especificada",247,114,133
2016,45 - 49 años,Fibrosis y cirrosis del hígado,228,172,56
2016,45 - 49 años,Exposición a factores no especificados,165,138,27
2016,45 - 49 años,Infarto agudo del miocardio,148,96,52
2016,45 - 49 años,"Agresión con disparo de otras armas de fuego, y las no especificadas",147,127,20
2016,45 - 49 años,"Neumonía, organismo no especificado",109,67,42
2016,45 - 49 años,Enfermedad alcohólica del hígado,107,93,14
2016,45 - 49 años,Diabetes mellitus no insulinodependiente,88,37,51
2016,45 - 49 años,"Accidente de vehículo de motor o sin motor, tipo de vehículo no especificado",86,71,15
2016,45 - 49 años,Tumor maligno del estómago,72,36,36
2016,45 - 49 años,Enfermedad renal crónica,69,29,40
2016,45 - 49 años,"Envenenamiento accidental por, y exposición al alcohol",66,62,4
2016,45 - 49 años,Tumor maligno del hígado y de las vías biliares intrahepáticas,59,24,35
2016,45 - 49 años,Trastornos mentales y del comportamiento debidos al uso de alcohol,53,49,4
2016,45 - 49 años,Otras gastroenteritis y colitis de origen infeccioso y no especificado,50,26,24
2016,45 - 49 años,"Síntomas, signos y hallazgos anormales clínicos y de laboratorio, no clasificados en otra parte",237,134,103
2016,45 - 49 años,Otras causas,1284,682,602
2016,50 - 54 años,"Diabetes mellitus, no especificada",377,154,223
2016,50 - 54 años,Fibrosis y cirrosis del hígado,284,202,82
2016,50 - 54 años,Infarto agudo del miocardio,228,141,87
2016,50 - 54 años,Exposición a factores no especificados,150,132,18
2016,50 - 54 años,"Neumonía, organismo no especificado",141,89,52
2016,50 - 54 años,"Agresión con disparo de otras armas de fuego, y las no especificadas",122,101,21
2016,50 - 54 años,Diabetes mellitus no insulinodependiente,113,44,69
2016,50 - 54 años,Enfermedad alcohólica del hígado,107,93,14
2016,50 - 54 años,Enfermedad renal crónica,90,30,60
2016,50 - 54 años,Tumor maligno del hígado y de las vías biliares intrahepáticas,82,41,41
2016,50 - 54 años,"Accidente de vehículo de motor o sin motor, tipo de vehículo no especificado",80,70,10
2016,50 - 54 años,Tumor maligno del estómago,76,37,39
2016,50 - 54 años,"Envenenamiento accidental por, y exposición al alcohol",59,55,4
2016,50 - 54 años,"Accidente vascular encefálico agudo, no especificado como hemorrágico o isquémico",56,27,29
2016,50 - 54 años,Otras gastroenteritis y colitis de origen infeccioso y no especificado,54,25,29
2016,50 - 54 años,"Síntomas, signos y hallazgos anormales clínicos y de laboratorio, no clasificados en otra parte",284,146,138
2016,50 - 54 años,Otras causas,1427,729,698
2016,55 - 59 años,"Diabetes mellitus, no especificada",499,202,297
2016,55 - 59 años,Fibrosis y cirrosis del hígado,352,222,130
2016,55 - 59 años,Infarto agudo del miocardio,307,183,124
2016,55 - 59 años,"Neumonía, organismo no especificado",202,106,96
2016,55 - 59 años,Diabetes mellitus no insulinodependiente,137,43,94
2016,55 - 59 años,Tumor maligno del hígado y de las vías biliares intrahepáticas,135,66,69
2016,55 - 59 años,Enfermedad renal crónica,133,64,69
2016,55 - 59 años,Exposición a factores no especificados,129,109,20
2016,55 - 59 años,Tumor maligno del estómago,115,55,60
2016,55 - 59 años,"Agresión con disparo de otras armas de fuego, y las no especificadas",83,72,11
2016,55 - 59 años,"Accidente vascular encefálico agudo, no especificado como hemorrágico o isquémico",81,34,47
2016,55 - 59 años,Enfermedad alcohólica del hígado,79,67,12
2016,55 - 59 años,Insuficiencia renal no especificada,77,43,34
2016,55 - 59 años,"Accidente de vehículo de motor o sin motor, tipo de vehículo no especificado",76,62,14
2016,55 - 59 años,Insuficiencia cardíaca,66,32,34
2016,55 - 59 años,"Síntomas, signos y hallazgos anormales clínicos y de laboratorio, no clasificados en otra parte",385,214,171
2016,55 - 59 años,Otras causas,1827,932,895
2016,60 - 64 años,"Diabetes mellitus, no especificada",579,228,351
2016,60 - 64 años,Infarto agudo del miocardio,371,219,152
2016,60 - 64 años,Fibrosis y cirrosis del hígado,332,201,131
2016,60 - 64 años,"Neumonía, organismo no especificado",251,131,120
2016,60 - 64 años,Tumor maligno del hígado y de las vías biliares intrahepáticas,183,88,95
2016,60 - 64 años,Diabetes mellitus no insulinodependiente,180,75,105
2016,60 - 64 años,Enfermedad renal crónica,162,73,89
2016,60 - 64 años,Exposición a factores no especificados,149,116,33
2016,60 - 64 años,Tumor maligno del estómago,141,66,75
2016,60 - 64 años,"Accidente vascular encefálico agudo, no especificado como hemorrágico o isquémico",98,51,47
2016,60 - 64 años,Otras gastroenteritis y colitis de origen infeccioso y no especificado,95,45,50
2016,60 - 64 años,Insuficiencia renal no especificada,90,48,42
2016,60 - 64 años,Insuficiencia cardíaca,78,32,46
2016,60 - 64 años,Otras enfermedades del sistema digestivo,67,33,34
2016,60 - 64 años,"Accidente de vehículo de motor o sin motor, tipo de vehículo no especificado",66,53,13
2016,60 - 64 años,"Síntomas, signos y hallazgos anormales clínicos y de laboratorio, no clasificados en otra parte",493,243,250
2016,60 - 64 años,Otras causas,1883,994,889
2016,65 - 69 años,"Diabetes mellitus, no especificada",620,244,376
2016,65 - 69 años,Infarto agudo del miocardio,488,256,232
2016,65 - 69 años,"Neumonía, organismo no especificado",331,173,158
2016,65 - 69 años,Fibrosis y cirrosis del hígado,274,151,123
2016,65 - 69 años,Diabetes mellitus no insulinodependiente,223,87,136
2016,65 - 69 años,Tumor maligno del hígado y de las vías biliares intrahepáticas,211,97,114
2016,65 - 69 años,"Accidente vascular encefálico agudo, no especificado como hemorrágico o isquémico",168,80,88
2016,65 - 69 años,Enfermedad renal crónica,165,84,81
2016,65 - 69 años,Tumor maligno del estómago,133,68,65
2016,65 - 69 años,Exposición a factores no especificados,126,101,25
2016,65 - 69 años,Insuficiencia renal no especificada,110,63,47
2016,65 - 69 años,Insuficiencia cardíaca,98,50,48
2016,65 - 69 años,Otras gastroenteritis y colitis de origen infeccioso y no especificado,93,34,59
2016,65 - 69 años,Otras enfermedades cerebrovasculares,65,28,37
2016,65 - 69 años,Otras enfermedades pulmonares obstructivas crónicas,63,31,32
2016,65 - 69 años,"Síntomas, signos y hallazgos anormales clínicos y de laboratorio, no clasificados en otra parte",550,285,265
2016,65 - 69 años,Otras causas,2042,1096,946
2016,70 - 74 años,Infarto agudo del miocardio,538,300,238
2016,70 - 74 años,"Diabetes mellitus, no especificada",505,196,309
2016,70 - 74 años,"Neumonía, organismo no especificado",462,243,219
2016,70 - 74 años,Fibrosis y cirrosis del hígado,211,111,100
2016,70 - 74 años,Tumor maligno del hígado y de las vías biliares intrahepáticas,191,101,90
2016,70 - 74 años,Diabetes mellitus no insulinodependiente,176,75,101
2016,70 - 74 años,"Accidente vascular encefálico agudo, no especificado como hemorrágico o isquémico",173,95,78
2016,70 - 74 años,Tumor maligno del estómago,139,65,74
2016,70 - 74 años,Insuficiencia cardíaca,134,67,67
2016,70 - 74 años,Enfermedad renal crónica,120,65,55
2016,70 - 74 años,Otras gastroenteritis y colitis de origen infeccioso y no especificado,117,44,73
2016,70 - 74 años,Exposición a factores no especificados,108,86,22
2016,70 - 74 años,Otras enfermedades pulmonares obstructivas crónicas,102,51,51
2016,70 - 74 años,Insuficiencia renal no especificada,94,50,44
2016,70 - 74 años,"Síntomas, signos y hallazgos anormales clínicos y de laboratorio, no clasificados en otra parte",661,349,312
2016,70 - 74 años,Otras causas,1981,1036,945
2016,75 - 79 años,Infarto agudo del miocardio,670,381,289
2016,75 - 79 años,"Neumonía, organismo no especificado",582,287,295
2016,75 - 79 años,"Diabetes mellitus, no especificada",459,174,285
2016,75 - 79 años,"Accidente vascular encefálico agudo, no especificado como hemorrágico o isquémico",247,117,130
2016,75 - 79 años,Insuficiencia cardíaca,189,87,102
2016,75 - 79 años,Tumor maligno del hígado y de las vías biliares intrahepáticas,181,78,103
2016,75 - 79 años,Fibrosis y cirrosis del hígado,175,92,83
2016,75 - 79 años,Tumor maligno del estómago,170,79,91
2016,75 - 79 años,Diabetes mellitus no insulinodependiente,156,64,92
2016,75 - 79 años,Otras gastroenteritis y colitis de origen infeccioso y no especificado,140,74,66
2016,75 - 79 años,Insuficiencia renal no especificada,131,61,70
2016,75 - 79 años,Otras enfermedades pulmonares obstructivas crónicas,130,71,59
2016,75 - 79 años,Enfermedad renal crónica,117,60,57
2016,75 - 79 años,Exposición a factores no especificados,109,67,42
2016,75 - 79 años,"Desnutrición proteicocalórica, no especificada",105,47,58
2016,75 - 79 años,"Síntomas, signos y hallazgos anormales clínicos y de laboratorio, no clasificados en otra parte",754,377,377
2016,75 - 79 años,Otras causas,2105,1108,997
2016,80 - 84 años,Infarto agudo del miocardio,801,407,394
2016,80 - 84 años,"Neumonía, organismo no especificado",755,395,360
2016,80 - 84 años,"Diabetes mellitus, no especificada",374,149,225
2016,80 - 84 años,"Accidente vascular encefálico agudo, no especificado como hemorrágico o isquémico",283,147,136
2016,80 - 84 años,Insuficiencia cardíaca,233,112,121
2016,80 - 84 años,Otras enfermedades pulmonares obstructivas crónicas,169,88,81
2016,80 - 84 años,Otras gastroenteritis y colitis de origen infeccioso y no especificado,141,64,77
2016,80 - 84 años,Diabetes mellitus no insulinodependiente,139,55,84
2016,80 - 84 años,Fibrosis y cirrosis del hígado,122,53,69
2016,80 - 84 años,Tumor maligno del estómago,120,54,66
2016,80 - 84 años,"Desnutrición proteicocalórica, no especificada",114,48,66
2016,80 - 84 años,Tumor maligno del hígado y de las vías biliares intrahepáticas,111,57,54
2016,80 - 84 años,Enfermedad renal crónica,111,55,56
2016,80 - 84 años,Hipertensión esencial (primaria),110,57,53
2016,80 - 84 años,"Síntomas, signos y hallazgos anormales clínicos y de laboratorio, no clasificados en otra parte",1011,456,555
2016,80 - 84 años,Otras causas,2061,1054,1007
2016,85 y más,Infarto agudo del miocardio,151,694,816
2016,85 y más,"Neumonía, organismo no especificado",1507,762,745
2016,85 y más,Insuficiencia cardíaca,544,235,309
2016,85 y más,"Accidente vascular encefálico agudo, no especificado como hemorrágico o isquémico",437,230,207
2016,85 y más,"Diabetes mellitus, no especificada",356,137,219
2016,85 y más,Otras enfermedades pulmonares obstructivas crónicas,292,140,152
2016,85 y más,"Desnutrición proteicocalórica, no especificada",265,109,156
2016,85 y más,Hipertensión esencial (primaria),237,101,136
2016,85 y más,Otras gastroenteritis y colitis de origen infeccioso y no especificado,193,94,99
2016,85 y más,Exposición a factores no especificados,165,83,82
2016,85 y más,Tumor maligno del estómago,155,60,95
2016,85 y más,Enfermedad renal crónica,151,78,73
2016,85 y más,Otras enfermedades cerebrovasculares,142,58,84
2016,85 y más,Insuficiencia renal no especificada,140,74,66
2016,85 y más,"Síntomas, signos y hallazgos anormales clínicos y de laboratorio, no clasificados en otra parte",2139,976,1163
2016,85 y más,Otras causas,2778,1314,1464
2017,1- 6 días,Dificultad respiratoria del recién nacido,397,250,147
2017,1- 6 días,Sepsis bacteriana del recién nacido,226,138,88
2017,1- 6 días,Neumonía congénita,164,103,61
2017,1- 6 días,Trastornos cardiovasculares originados en el período perinatal,117,73,44
2017,1- 6 días,Síndromes de aspiración neonatal,108,63,45
2017,1- 6 días,Asfixia del nacimiento,89,63,26
2017,1- 6 días,"Otras malformaciones congénitas, no clasificadas en otra parte",76,40,36
2017,1- 6 días,Otras malformaciones congénitas del corazón,70,47,23
2017,1- 6 días,"Trastornos relacionados con duración corta de la gestación y con bajo peso al nacer, no clasificados en otra parte",66,38,28
2017,1- 6 días,Hemorragia pulmonar originada en el período perinatal,46,24,22
2017,1- 6 días,Coagulación intravascular diseminada en el feto y el recién nacido,45,26,19
2017,1- 6 días,"Enfisema intersticial y afecciones relacionadas, originadas en el período perinatal",28,15,13
2017,1- 6 días,Enterocolitis necrotizante del feto y del recién nacido,24,12,12
2017,1- 6 días,"Otros problemas respiratorios del recién nacido, originados en el período perinatal",21,14,7
2017,1- 6 días,"Malformaciones congénitas del sistema osteomuscular, no clasificadas en otra parte",12,8,4
2017,1- 6 días,"Síntomas, signos y hallazgos anormales clínicos y de laboratorio, no clasificados en otra parte",82,47,35
2017,1- 6 días,Otras causas,251,140,111
2017,7 - 27 días,Neumonía congénita,277,167,110
2017,7 - 27 días,Sepsis bacteriana del recién nacido,232,141,91
2017,7 - 27 días,Dificultad respiratoria del recién nacido,116,76,40
2017,7 - 27 días,Trastornos cardiovasculares originados en el período perinatal,60,34,26
2017,7 - 27 días,Otras malformaciones congénitas del corazón,55,26,29
2017,7 - 27 días,Coagulación intravascular diseminada en el feto y el recién nacido,46,27,19
2017,7 - 27 días,Enterocolitis necrotizante del feto y del recién nacido,46,28,18
2017,7 - 27 días,"Trastornos relacionados con duración corta de la gestación y con bajo peso al nacer, no clasificados en otra parte",41,22,19
2017,7 - 27 días,Hemorragia pulmonar originada en el período perinatal,38,24,14
2017,7 - 27 días,Asfixia del nacimiento,30,19,11
2017,7 - 27 días,Síndromes de aspiración neonatal,28,18,10
2017,7 - 27 días,Otras hemorragias neonatales,28,15,13
2017,7 - 27 días,"Otras malformaciones congénitas, no clasificadas en otra parte",28,16,12
2017,7 - 27 días,Otros trastornos perinatales del sistema digestivo,26,13,13
2017,7 - 27 días,"Otros problemas respiratorios del recién nacido, originados en el período perinatal",24,15,9
2017,7 - 27 días,"Síntomas, signos y hallazgos anormales clínicos y de laboratorio, no clasificados en otra parte",83,52,31
2017,7 - 27 días,Otras causas,290,166,124
2017,28 días a menos de 1 año,"Neumonía, organismo no especificado",1113,635,478
2017,28 días a menos de 1 año,Otras gastroenteritis y colitis de origen infeccioso y no especificado,340,194,146
2017,28 días a menos de 1 año,Otras sepsis,196,109,87
2017,28 días a menos de 1 año,Otras malformaciones congénitas del corazón,170,94,76
2017,28 días a menos de 1 año,Coagulación intravascular diseminada [síndrome de desfibrinación],63,40,23
2017,28 días a menos de 1 año,"Desnutrición proteicocalórica severa, no especificada",51,29,22
2017,28 días a menos de 1 año,Otros trastornos respiratorios,51,25,26
2017,28 días a menos de 1 año,"Otras malformaciones congénitas, no clasificadas en otra parte",50,26,24
2017,28 días a menos de 1 año,"Neumonía bacteriana, no clasificada en otra parte",49,22,27
2017,28 días a menos de 1 año,"Desnutrición proteicocalórica, no especificada",48,23,25
2017,28 días a menos de 1 año,Hidrocéfalo,47,24,23
2017,28 días a menos de 1 año,Obstrucción no especificada de la respiración,44,27,17
2017,28 días a menos de 1 año,Sepsis bacteriana del recién nacido,36,22,14
2017,28 días a menos de 1 año,Síndrome de dificultad respiratoria del adulto,35,17,18
2017,28 días a menos de 1 año,Malformaciones congénitas del pulmón,33,16,17
2017,28 días a menos de 1 año,"Síntomas, signos y hallazgos anormales clínicos y de laboratorio, no clasificados en otra parte",435,242,193
2017,28 días a menos de 1 año,Otras causas,924,517,407
2017,1 año,"Neumonía, organismo no especificado",340,171,169
2017,1 año,Otras gastroenteritis y colitis de origen infeccioso y no especificado,263,135,128
2017,1 año,Otras sepsis,41,26,15
2017,1 año,Otras malformaciones congénitas del corazón,30,16,14
2017,1 año,Coagulación intravascular diseminada [síndrome de desfibrinación],29,17,12
2017,1 año,"Otros trastornos de los líquidos, de los electrólitos y del equilibrio ácido-básico",22,12,10
2017,1 año,"Desnutrición proteicocalórica, no especificada",21,8,13
2017,1 año,Depleción del volumen,19,7,12
2017,1 año,"Desnutrición proteicocalórica severa, no especificada",18,11,7
2017,1 año,Exposición a factores no especificados,17,9,8
2017,1 año,"Neumonía bacteriana, no clasificada en otra parte",16,7,9
2017,1 año,Complicaciones y descripciones mal definidas de enfermedad cardíaca,12,6,6
2017,1 año,Hidrocéfalo,11,3,8
2017,1 año,Neumonitis debida a sólidos y líquidos,11,8,3
2017,1 año,Obstrucción no especificada de la respiración,11,5,6
2017,1 año,"Síntomas, signos y hallazgos anormales clínicos y de laboratorio, no clasificados en otra parte",136,80,56
2017,1 año,Otras causas,305,166,139
2017,2 años,"Neumonía, organismo no especificado",112,65,47
2017,2 años,Otras gastroenteritis y colitis de origen infeccioso y no especificado,96,49,47
2017,2 años,Exposición a factores no especificados,15,9,6
2017,2 años,"Desnutrición proteicocalórica severa, no especificada",14,5,9
2017,2 años,Depleción del volumen,12,7,5
2017,2 años,Coagulación intravascular diseminada [síndrome de desfibrinación],8,4,4
2017,2 años,"Accidente de vehículo de motor o sin motor, tipo de vehículo no especificado",8,5,3
2017,2 años,Ahogamiento y sumersión no especificados,8,7,1
2017,2 años,Otros trastornos respiratorios,7,3,4
2017,2 años,Otras sepsis,6,2,4
2017,2 años,Neumonitis debida a sólidos y líquidos,6,3,3
2017,2 años,Varicela,5,4,1
2017,2 años,"Otros trastornos de los líquidos, de los electrólitos y del equilibrio ácido-básico",5,2,3
2017,2 años,Otras malformaciones congénitas del corazón,5,1,4
2017,2 años,Síndrome de Down,5,3,2
2017,2 años,"Síntomas, signos y hallazgos anormales clínicos y de laboratorio, no clasificados en otra parte",60,30,30
2017,2 años,Otras causas,136,79,57
2017,3 años,"Neumonía, organismo no especificado",50,30,20
2017,3 años,Otras gastroenteritis y colitis de origen infeccioso y no especificado,38,12,26
2017,3 años,Exposición a factores no especificados,13,4,9
2017,3 años,Otras sepsis,10,5,5
2017,3 años,"Accidente de vehículo de motor o sin motor, tipo de vehículo no especificado",8,4,4
2017,3 años,Obstrucción no especificada de la respiración,8,4,4
2017,3 años,"Exposición a humos, fuegos o llamas no especificados",8,5,3
2017,3 años,Leucemia linfoide,5,3,2
2017,3 años,Tumor maligno del ojo y sus anexos,4,2,2
2017,3 años,Coagulación intravascular diseminada [síndrome de desfibrinación],4,1,3
2017,3 años,Otros trastornos respiratorios,4,3,1
2017,3 años,Otras enfermedades del sistema digestivo,4,3,1
2017,3 años,Ahogamiento y sumersión no especificados,4,3,1
2017,3 años,"Otros trastornos de los líquidos, de los electrólitos y del equilibrio ácido-básico",3,2,1
2017,3 años,"Síntomas, signos y hallazgos anormales clínicos y de laboratorio, no clasificados en otra parte",26,10,16
2017,3 años,Otras causas,84,39,45
2017,4 años,"Neumonía, organismo no especificado",30,8,22
2017,4 años,Otras gastroenteritis y colitis de origen infeccioso y no especificado,25,12,13
2017,4 años,"Accidente de vehículo de motor o sin motor, tipo de vehículo no especificado",10,9,1
2017,4 años,Exposición a factores no especificados,10,7,3
2017,4 años,Otras sepsis,5,4,1
2017,4 años,Leucemia linfoide,5,3,2
2017,4 años,Otros síndromes paralíticos,5,2,3
2017,4 años,"Exposición a humos, fuegos o llamas no especificados",5,2,3
2017,4 años,Leucemia de células de tipo no especificado,4,2,2
2017,4 años,Parálisis cerebral,4,2,2
2017,4 años,Otras malformaciones congénitas del corazón,4,3,1
2017,4 años,Coagulación intravascular diseminada [síndrome de desfibrinación],3,2,1
2017,4 años,Depleción del volumen,3,1,2
2017,4 años,Otros trastornos respiratorios,3,2,1
2017,4 años,"Síntomas, signos y hallazgos anormales clínicos y de laboratorio, no clasificados en otra parte",19,8,11
2017,4 años,Otras causas,71,41,30
2017,5 - 9 años,"Neumonía, organismo no especificado",61,28,33
2017,5 - 9 años,Exposición a factores no especificados,58,37,21
2017,5 - 9 años,Otras gastroenteritis y colitis de origen infeccioso y no especificado,56,31,25
2017,5 - 9 años,Otras sepsis,28,15,13
2017,5 - 9 años,Leucemia linfoide,22,12,10
2017,5 - 9 años,"Accidente de vehículo de motor o sin motor, tipo de vehículo no especificado",21,10,11
2017,5 - 9 años,Ahogamiento y sumersión no especificados,17,13,4
2017,5 - 9 años,Epilepsia,12,6,6
2017,5 - 9 años,Apendicitis aguda,11,4,7
2017,5 - 9 años,Obstrucción no especificada de la respiración,10,5,5
2017,5 - 9 años,Tumor maligno del encéfalo,9,4,5
2017,5 - 9 años,Coagulación intravascular diseminada [síndrome de desfibrinación],9,5,4
2017,5 - 9 años,Otros síndromes paralíticos,9,3,6
2017,5 - 9 años,Complicaciones y descripciones mal definidas de enfermedad cardíaca,9,4,5
2017,5 - 9 años,Leucemia mieloide,8,4,4
2017,5 - 9 años,"Síntomas, signos y hallazgos anormales clínicos y de laboratorio, no clasificados en otra parte",73,39,34
2017,5 - 9 años,Otras causas,283,140,143
2017,10 - 14 años,"Neumonía, organismo no especificado",62,32,30
2017,10 - 14 años,Otras gastroenteritis y colitis de origen infeccioso y no especificado,39,19,20
2017,10 - 14 años,"Accidente de vehículo de motor o sin motor, tipo de vehículo no especificado",39,29,10
2017,10 - 14 años,Exposición a factores no especificados,39,32,7
2017,10 - 14 años,"Agresión con disparo de otras armas de fuego, y las no especificadas",38,29,9
2017,10 - 14 años,Leucemia linfoide,31,19,12
2017,10 - 14 años,Otros estrangulamientos y ahorcamientos accidentales,29,19,10
2017,10 - 14 años,Enfermedad renal crónica,17,7,10
2017,10 - 14 años,Ahogamiento y sumersión no especificados,17,15,2
2017,10 - 14 años,Epilepsia,16,6,10
2017,10 - 14 años,"Disparo de otras armas de fuego, y las no especificadas",14,9,5
2017,10 - 14 años,Complicaciones y descripciones mal definidas de enfermedad cardíaca,12,7,5
2017,10 - 14 años,Parálisis cerebral,11,3,8
2017,10 - 14 años,"Exposición a humos, fuegos o llamas no especificados",11,3,8
2017,10 - 14 años,Otras sepsis,9,6,3
2017,10 - 14 años,"Síntomas, signos y hallazgos anormales clínicos y de laboratorio, no clasificados en otra parte",71,39,32
2017,10 - 14 años,Otras causas,310,150,160
2017,15 - 19 años,"Agresión con disparo de otras armas de fuego, y las no especificadas",563,499,64
2017,15 - 19 años,Exposición a factores no especificados,184,159,25
2017,15 - 19 años,"Accidente de vehículo de motor o sin motor, tipo de vehículo no especificado",144,120,24
2017,15 - 19 años,"Disparo de otras armas de fuego, y las no especificadas",120,107,13
2017,15 - 19 años,"Neumonía, organismo no especificado",80,51,29
2017,15 - 19 años,Otros estrangulamientos y ahorcamientos accidentales,56,40,16
2017,15 - 19 años,"Lesión autoinfligida intencionalmente por ahorcamiento, estrangulamiento o sofocación",45,26,19
2017,15 - 19 años,Ahogamiento y sumersión no especificados,41,36,5
2017,15 - 19 años,Agresión con objeto cortante,41,31,10
2017,15 - 19 años,Enfermedad renal crónica,40,20,20
2017,15 - 19 años,"Agresión por ahorcamiento, estrangulamiento y sofocación",40,31,9
2017,15 - 19 años,Agresión por medios no especificados,35,30,5
2017,15 - 19 años,Leucemia linfoide,33,12,21
2017,15 - 19 años,"Exposición a humos, fuegos o llamas no especificados",33,7,26
2017,15 - 19 años,"Envenenamiento accidental por, y exposición a otros productos químicos y sustancias nocivas, y los no especificados",32,18,14
2017,15 - 19 años,"Síntomas, signos y hallazgos anormales clínicos y de laboratorio, no clasificados en otra parte",143,86,57
2017,15 - 19 años,Otras causas,797,439,358
2017,20 - 24 años,"Agresión con disparo de otras armas de fuego, y las no especificadas",609,547,62
2017,20 - 24 años,Exposición a factores no especificados,348,321,27
2017,20 - 24 años,"Accidente de vehículo de motor o sin motor, tipo de vehículo no especificado",270,241,29
2017,20 - 24 años,"Disparo de otras armas de fuego, y las no especificadas",144,131,13
2017,20 - 24 años,"Neumonía, organismo no especificado",78,46,32
2017,20 - 24 años,Otros estrangulamientos y ahorcamientos accidentales,60,45,15
2017,20 - 24 años,Agresión con objeto cortante,55,43,12
2017,20 - 24 años,"Lesión autoinfligida intencionalmente por ahorcamiento, estrangulamiento o sofocación",50,44,6
2017,20 - 24 años,Ahogamiento y sumersión no especificados,41,40,1
2017,20 - 24 años,Agresión por medios no especificados,41,36,5
2017,20 - 24 años,Enfermedad renal crónica,38,21,17
2017,20 - 24 años,"Envenenamiento accidental por, y exposición a otros productos químicos y sustancias nocivas, y los no especificados",38,21,17
2017,20 - 24 años,"Envenenamiento accidental por, y exposición al alcohol",36,34,2
2017,20 - 24 años,Otras gastroenteritis y colitis de origen infeccioso y no especificado,35,22,13
2017,20 - 24 años,Otras sepsis,31,19,12
2017,20 - 24 años,"Síntomas, signos y hallazgos anormales clínicos y de laboratorio, no clasificados en otra parte",165,102,63
2017,20 - 24 años,Otras causas,953,548,405
2017,25 - 29 años,"Agresión con disparo de otras armas de fuego, y las no especificadas",470,406,64
2017,25 - 29 años,Exposición a factores no especificados,277,248,29
2017,25 - 29 años,"Accidente de vehículo de motor o sin motor, tipo de vehículo no especificado",216,200,16
2017,25 - 29 años,"Disparo de otras armas de fuego, y las no especificadas",118,103,15
2017,25 - 29 años,"Neumonía, organismo no especificado",79,53,26
2017,25 - 29 años,Fibrosis y cirrosis del hígado,59,56,3
2017,25 - 29 años,Infarto agudo del miocardio,47,38,9
2017,25 - 29 años,Agresión con objeto cortante,46,35,11
2017,25 - 29 años,Otros estrangulamientos y ahorcamientos accidentales,45,43,2
2017,25 - 29 años,Enfermedad renal crónica,44,25,19
2017,25 - 29 años,"Envenenamiento accidental por, y exposición al alcohol",43,38,5
2017,25 - 29 años,Otras gastroenteritis y colitis de origen infeccioso y no especificado,37,20,17
2017,25 - 29 años,"Lesión autoinfligida intencionalmente por ahorcamiento, estrangulamiento o sofocación",37,32,5
2017,25 - 29 años,"Diabetes mellitus, no especificada",32,10,22
2017,25 - 29 años,Enfermedad alcohólica del hígado,29,27,2
2017,25 - 29 años,"Síntomas, signos y hallazgos anormales clínicos y de laboratorio, no clasificados en otra parte",179,118,61
2017,25 - 29 años,Otras causas,967,561,406
2017,30 - 34 años,"Agresión con disparo de otras armas de fuego, y las no especificadas",342,295,47
2017,30 - 34 años,Exposición a factores no especificados,242,216,26
2017,30 - 34 años,"Accidente de vehículo de motor o sin motor, tipo de vehículo no especificado",154,129,25
2017,30 - 34 años,"Neumonía, organismo no especificado",95,64,31
2017,30 - 34 años,Fibrosis y cirrosis del hígado,89,75,14
2017,30 - 34 años,"Disparo de otras armas de fuego, y las no especificadas",82,75,7
2017,30 - 34 años,"Envenenamiento accidental por, y exposición al alcohol",73,66,7
2017,30 - 34 años,Infarto agudo del miocardio,63,42,21
2017,30 - 34 años,Enfermedad alcohólica del hígado,56,47,9
2017,30 - 34 años,Trastornos mentales y del comportamiento debidos al uso de alcohol,50,44,6
2017,30 - 34 años,"Diabetes mellitus, no especificada",48,26,22
2017,30 - 34 años,Agresión por medios no especificados,38,34,4
2017,30 - 34 años,"Enfermedad por virus de la inmunodeficiencia humana [VIH], resultante en enfermedades infecciosas y parasitarias",37,23,14
2017,30 - 34 años,Otros estrangulamientos y ahorcamientos accidentales,34,30,4
2017,30 - 34 años,Agresión con objeto cortante,31,21,10
2017,30 - 34 años,"Síntomas, signos y hallazgos anormales clínicos y de laboratorio, no clasificados en otra parte",192,127,65
2017,30 - 34 años,Otras causas,1003,551,452
2017,35 - 39 años,"Agresión con disparo de otras armas de fuego, y las no especificadas",299,261,38
2017,35 - 39 años,Exposición a factores no especificados,210,184,26
2017,35 - 39 años,Fibrosis y cirrosis del hígado,155,127,28
2017,35 - 39 años,Infarto agudo del miocardio,106,74,32
2017,35 - 39 años,"Accidente de vehículo de motor o sin motor, tipo de vehículo no especificado",104,91,13
2017,35 - 39 años,"Diabetes mellitus, no especificada",95,53,42
2017,35 - 39 años,"Neumonía, organismo no especificado",91,53,38
2017,35 - 39 años,"Envenenamiento accidental por, y exposición al alcohol",87,80,7
2017,35 - 39 años,"Disparo de otras armas de fuego, y las no especificadas",73,59,14
2017,35 - 39 años,Enfermedad alcohólica del hígado,71,64,7
2017,35 - 39 años,Enfermedad renal crónica,49,30,19
2017,35 - 39 años,Trastornos mentales y del comportamiento debidos al uso de alcohol,45,40,5
2017,35 - 39 años,Tumor maligno del estómago,36,15,21
2017,35 - 39 años,Tumor maligno del hígado y de las vías biliares intrahepáticas,35,14,21
2017,35 - 39 años,Diabetes mellitus no insulinodependiente,35,20,15
2017,35 - 39 años,"Síntomas, signos y hallazgos anormales clínicos y de laboratorio, no clasificados en otra parte",233,147,86
2017,35 - 39 años,Otras causas,1189,682,507
2017,40 - 44 años,"Agresión con disparo de otras armas de fuego, y las no especificadas",207,178,29
2017,40 - 44 años,Fibrosis y cirrosis del hígado,196,154,42
2017,40 - 44 años,Exposición a factores no especificados,171,156,15
2017,40 - 44 años,"Diabetes mellitus, no especificada",151,69,82
2017,40 - 44 años,Infarto agudo del miocardio,134,92,42
2017,40 - 44 años,"Accidente de vehículo de motor o sin motor, tipo de vehículo no especificado",106,90,16
2017,40 - 44 años,"Neumonía, organismo no especificado",96,55,41
2017,40 - 44 años,"Envenenamiento accidental por, y exposición al alcohol",92,84,8
2017,40 - 44 años,Enfermedad alcohólica del hígado,86,76,10
2017,40 - 44 años,Trastornos mentales y del comportamiento debidos al uso de alcohol,64,60,4
2017,40 - 44 años,Diabetes mellitus no insulinodependiente,52,22,30
2017,40 - 44 años,Enfermedad renal crónica,45,23,22
2017,40 - 44 años,"Disparo de otras armas de fuego, y las no especificadas",43,36,7
2017,40 - 44 años,Otras gastroenteritis y colitis de origen infeccioso y no especificado,38,17,21
2017,40 - 44 años,"Síntomas, signos y hallazgos anormales clínicos y de laboratorio, no clasificados en otra parte",218,142,76
2017,40 - 44 años,Otras causas,1212,655,557
2017,45 - 49 años,"Diabetes mellitus, no especificada",241,95,146
2017,45 - 49 años,Fibrosis y cirrosis del hígado,208,152,56
2017,45 - 49 años,Infarto agudo del miocardio,147,95,52
2017,45 - 49 años,Exposición a factores no especificados,145,125,20
2017,45 - 49 años,"Agresión con disparo de otras armas de fuego, y las no especificadas",139,124,15
2017,45 - 49 años,"Neumonía, organismo no especificado",113,66,47
2017,45 - 49 años,Diabetes mellitus no insulinodependiente,81,34,47
2017,45 - 49 años,Enfermedad alcohólica del hígado,80,76,4
2017,45 - 49 años,"Accidente de vehículo de motor o sin motor, tipo de vehículo no especificado",79,68,11
2017,45 - 49 años,"Envenenamiento accidental por, y exposición al alcohol",76,71,5
2017,45 - 49 años,Enfermedad renal crónica,75,33,42
2017,45 - 49 años,Tumor maligno del estómago,55,16,39
2017,45 - 49 años,Tumor maligno del hígado y de las vías biliares intrahepáticas,55,25,30
2017,45 - 49 años,Trastornos mentales y del comportamiento debidos al uso de alcohol,53,52,1
2017,45 - 49 años,"Síntomas, signos y hallazgos anormales clínicos y de laboratorio, no clasificados en otra parte",286,176,110
2017,45 - 49 años,Otras causas,1335,755,580
2017,50 - 54 años,"Diabetes mellitus, no especificada",344,143,201
2017,50 - 54 años,Fibrosis y cirrosis del hígado,284,205,79
2017,50 - 54 años,Infarto agudo del miocardio,223,137,86
2017,50 - 54 años,"Neumonía, organismo no especificado",144,78,66
2017,50 - 54 años,Exposición a factores no especificados,116,92,24
2017,50 - 54 años,Diabetes mellitus no insulinodependiente,115,50,65
2017,50 - 54 años,"Agresión con disparo de otras armas de fuego, y las no especificadas",101,87,14
2017,50 - 54 años,Enfermedad alcohólica del hígado,93,82,11
2017,50 - 54 años,Enfermedad renal crónica,93,42,51
2017,50 - 54 años,Tumor maligno del hígado y de las vías biliares intrahepáticas,88,38,50
2017,50 - 54 años,Tumor maligno del estómago,81,33,48
2017,50 - 54 años,"Accidente de vehículo de motor o sin motor, tipo de vehículo no especificado",79,70,9
2017,50 - 54 años,Insuficiencia renal no especificada,65,29,36
2017,50 - 54 años,"Envenenamiento accidental por, y exposición al alcohol",64,58,6
2017,50 - 54 años,"Accidente vascular encefálico agudo, no especificado como hemorrágico o isquémico",59,20,39
2017,50 - 54 años,"Síntomas, signos y hallazgos anormales clínicos y de laboratorio, no clasificados en otra parte",325,177,148
2017,50 - 54 años,Otras causas,1425,739,686
2017,55 - 59 años,"Diabetes mellitus, no especificada",511,212,299
2017,55 - 59 años,Fibrosis y cirrosis del hígado,273,178,95
2017,55 - 59 años,Infarto agudo del miocardio,270,149,121
2017,55 - 59 años,"Neumonía, organismo no especificado",206,99,107
2017,55 - 59 años,Diabetes mellitus no insulinodependiente,177,73,104
2017,55 - 59 años,Tumor maligno del hígado y de las vías biliares intrahepáticas,155,73,82
2017,55 - 59 años,Enfermedad renal crónica,151,77,74
2017,55 - 59 años,Exposición a factores no especificados,119,103,16
2017,55 - 59 años,Enfermedad alcohólica del hígado,90,79,11
2017,55 - 59 años,Tumor maligno del estómago,83,39,44
2017,55 - 59 años,Insuficiencia renal no especificada,74,35,39
2017,55 - 59 años,"Agresión con disparo de otras armas de fuego, y las no especificadas",67,60,7
2017,55 - 59 años,"Accidente vascular encefálico agudo, no especificado como hemorrágico o isquémico",63,23,40
2017,55 - 59 años,"Accidente de vehículo de motor o sin motor, tipo de vehículo no especificado",62,50,12
2017,55 - 59 años,Otras sepsis,57,25,32
2017,55 - 59 años,"Síntomas, signos y hallazgos anormales clínicos y de laboratorio, no clasificados en otra parte",425,222,203
2017,55 - 59 años,Otras causas,1704,871,833
2017,60 - 64 años,"Diabetes mellitus, no especificada",626,244,382
2017,60 - 64 años,Infarto agudo del miocardio,386,220,166
2017,60 - 64 años,Fibrosis y cirrosis del hígado,270,158,112
2017,60 - 64 años,"Neumonía, organismo no especificado",235,122,113
2017,60 - 64 años,Diabetes mellitus no insulinodependiente,217,76,141
2017,60 - 64 años,Enfermedad renal crónica,171,95,76
2017,60 - 64 años,Tumor maligno del hígado y de las vías biliares intrahepáticas,170,71,99
2017,60 - 64 años,Exposición a factores no especificados,118,91,27
2017,60 - 64 años,Tumor maligno del estómago,115,60,55
2017,60 - 64 años,"Accidente vascular encefálico agudo, no especificado como hemorrágico o isquémico",99,48,51
2017,60 - 64 años,Insuficiencia renal no especificada,97,56,41
2017,60 - 64 años,Otras gastroenteritis y colitis de origen infeccioso y no especificado,76,35,41
2017,60 - 64 años,Insuficiencia cardíaca,74,37,37
2017,60 - 64 años,"Accidente de vehículo de motor o sin motor, tipo de vehículo no especificado",62,50,12
2017,60 - 64 años,Otras enfermedades del sistema digestivo,61,32,29
2017,60 - 64 años,"Síntomas, signos y hallazgos anormales clínicos y de laboratorio, no clasificados en otra parte",457,225,232
2017,60 - 64 años,Otras causas,1829,974,855
2017,65 - 69 años,"Diabetes mellitus, no especificada",614,243,371
2017,65 - 69 años,Infarto agudo del miocardio,499,279,220
2017,65 - 69 años,"Neumonía, organismo no especificado",341,194,147
2017,65 - 69 años,Fibrosis y cirrosis del hígado,261,142,119
2017,65 - 69 años,Tumor maligno del hígado y de las vías biliares intrahepáticas,239,118,121
2017,65 - 69 años,Diabetes mellitus no insulinodependiente,205,84,121
2017,65 - 69 años,Tumor maligno del estómago,169,96,73
2017,65 - 69 años,Enfermedad renal crónica,166,79,87
2017,65 - 69 años,Insuficiencia renal no especificada,119,72,47
2017,65 - 69 años,Exposición a factores no especificados,116,82,34
2017,65 - 69 años,"Accidente vascular encefálico agudo, no especificado como hemorrágico o isquémico",111,50,61
2017,65 - 69 años,Insuficiencia cardíaca,97,49,48
2017,65 - 69 años,Otras gastroenteritis y colitis de origen infeccioso y no especificado,95,57,38
2017,65 - 69 años,Otras enfermedades cerebrovasculares,83,46,37
2017,65 - 69 años,Otras enfermedades del sistema digestivo,66,28,38
2017,65 - 69 años,"Síntomas, signos y hallazgos anormales clínicos y de laboratorio, no clasificados en otra parte",586,297,289
2017,65 - 69 años,Otras causas,1989,1068,921
2017,70 - 74 años,Infarto agudo del miocardio,543,290,253
2017,70 - 74 años,"Diabetes mellitus, no especificada",521,205,316
2017,70 - 74 años,"Neumonía, organismo no especificado",450,244,206
2017,70 - 74 años,Tumor maligno del hígado y de las vías biliares intrahepáticas,223,105,118
2017,70 - 74 años,Fibrosis y cirrosis del hígado,219,118,101
2017,70 - 74 años,Diabetes mellitus no insulinodependiente,187,76,111
2017,70 - 74 años,"Accidente vascular encefálico agudo, no especificado como hemorrágico o isquémico",174,91,83
2017,70 - 74 años,Tumor maligno del estómago,163,74,89
2017,70 - 74 años,Enfermedad renal crónica,142,83,59
2017,70 - 74 años,Insuficiencia cardíaca,131,57,74
2017,70 - 74 años,Insuficiencia renal no especificada,115,58,57
2017,70 - 74 años,Otras gastroenteritis y colitis de origen infeccioso y no especificado,105,52,53
2017,70 - 74 años,Exposición a factores no especificados,105,72,33
2017,70 - 74 años,Otras enfermedades cerebrovasculares,95,48,47
2017,70 - 74 años,Otras enfermedades pulmonares obstructivas crónicas,95,56,39
2017,70 - 74 años,"Síntomas, signos y hallazgos anormales clínicos y de laboratorio, no clasificados en otra parte",676,349,327
2017,70 - 74 años,Otras causas,1992,1074,918
2017,75 - 79 años,Infarto agudo del miocardio,660,339,321
2017,75 - 79 años,"Neumonía, organismo no especificado",610,329,281
2017,75 - 79 años,"Diabetes mellitus, no especificada",455,186,269
2017,75 - 79 años,"Accidente vascular encefálico agudo, no especificado como hemorrágico o isquémico",218,127,91
2017,75 - 79 años,Insuficiencia cardíaca,172,82,90
2017,75 - 79 años,Tumor maligno del hígado y de las vías biliares intrahepáticas,162,77,85
2017,75 - 79 años,Diabetes mellitus no insulinodependiente,159,55,104
2017,75 - 79 años,Enfermedad renal crónica,146,92,54
2017,75 - 79 años,Fibrosis y cirrosis del hígado,143,66,77
2017,75 - 79 años,Tumor maligno del estómago,136,76,60
2017,75 - 79 años,Otras gastroenteritis y colitis de origen infeccioso y no especificado,124,58,66
2017,75 - 79 años,Otras enfermedades pulmonares obstructivas crónicas,119,62,57
2017,75 - 79 años,Otras enfermedades cerebrovasculares,115,55,60
2017,75 - 79 años,Exposición a factores no especificados,110,72,38
2017,75 - 79 años,"Síntomas, signos y hallazgos anormales clínicos y de laboratorio, no clasificados en otra parte",863,449,414
2017,75 - 79 años,Otras causas,2118,1047,1071
2017,80 - 84 años,"Neumonía, organismo no especificado",781,373,408
2017,80 - 84 años,Infarto agudo del miocardio,747,410,337
2017,80 - 84 años,"Diabetes mellitus, no especificada",412,173,239
2017,80 - 84 años,"Accidente vascular encefálico agudo, no especificado como hemorrágico o isquémico",265,123,142
2017,80 - 84 años,Insuficiencia cardíaca,203,99,104
2017,80 - 84 años,Otras enfermedades pulmonares obstructivas crónicas,169,82,87
2017,80 - 84 años,Tumor maligno del estómago,142,60,82
2017,80 - 84 años,Otras enfermedades cerebrovasculares,132,59,73
2017,80 - 84 años,Otras gastroenteritis y colitis de origen infeccioso y no especificado,123,64,59
2017,80 - 84 años,Diabetes mellitus no insulinodependiente,123,44,79
2017,80 - 84 años,Hipertensión esencial (primaria),116,38,78
2017,80 - 84 años,Enfermedad renal crónica,112,58,54
2017,80 - 84 años,Insuficiencia renal no especificada,105,62,43
2017,80 - 84 años,Exposición a factores no especificados,104,72,32
2017,80 - 84 años,"Síntomas, signos y hallazgos anormales clínicos y de laboratorio, no clasificados en otra parte",1115,564,551
2017,80 - 84 años,Otras causas,2062,1043,1019
2017,85 y más,"Neumonía, organismo no especificado",1643,828,815
2017,85 y más,Infarto agudo del miocardio,1626,781,845
2017,85 y más,Insuficiencia cardíaca,569,241,328
2017,85 y más,"Accidente vascular encefálico agudo, no especificado como hemorrágico o isquémico",474,214,260
2017,85 y más,"Diabetes mellitus, no especificada",387,145,242
2017,85 y más,Otras enfermedades pulmonares obstructivas crónicas,307,168,139
2017,85 y más,"Desnutrición proteicocalórica, no especificada",284,123,161
2017,85 y más,Hipertensión esencial (primaria),224,90,134
2017,85 y más,Otras enfermedades cerebrovasculares,203,93,110
2017,85 y más,Otras gastroenteritis y colitis de origen infeccioso y no especificado,185,74,111
2017,85 y más,Exposición a factores no especificados,179,88,91
2017,85 y más,Tumor maligno del estómago,155,85,70
2017,85 y más,Enfermedad renal crónica,151,69,82
2017,85 y más,Insuficiencia renal no especificada,149,72,77
2017,85 y más,"Síntomas, signos y hallazgos anormales clínicos y de laboratorio, no clasificados en otra parte",2354,1063,1291
2017,85 y más,Otras causas,2881,1311,157
2018,1- 6 días,Dificultad respiratoria del recién nacido,399,226,173
2018,1- 6 días,Sepsis bacteriana del recién nacido,194,115,79
2018,1- 6 días,Neumonía congénita,151,98,53
2018,1- 6 días,Síndromes de aspiración neonatal,128,75,53
2018,1- 6 días,Trastornos cardiovasculares originados en el período perinatal,113,53,60
2018,1- 6 días,Asfixia del nacimiento,110,67,43
2018,1- 6 días,"Otras malformaciones congénitas, no clasificadas en otra parte",80,42,38
2018,1- 6 días,Otras malformaciones congénitas del corazón,79,41,38
2018,1- 6 días,"Trastornos relacionados con duración corta de la gestación y con bajo peso al nacer, no clasificados en otra parte",70,37,33
2018,1- 6 días,Hemorragia pulmonar originada en el período perinatal,48,30,18
2018,1- 6 días,Coagulación intravascular diseminada en el feto y el recién nacido,33,17,16
2018,1- 6 días,"Enfisema intersticial y afecciones relacionadas, originadas en el período perinatal",29,14,15
2018,1- 6 días,Enterocolitis necrotizante del feto y del recién nacido,26,13,13
2018,1- 6 días,"Otros problemas respiratorios del recién nacido, originados en el período perinatal",18,10,8
2018,1- 6 días,Hernia diafragmática,17,11,6
2018,1- 6 días,"Síntomas, signos y hallazgos anormales clínicos y de laboratorio, no clasificados en otra parte",90,58,32
2018,1- 6 días,Otras causas,256,143,113
2018,7 - 27 días,Neumonía congénita,249,144,105
2018,7 - 27 días,Sepsis bacteriana del recién nacido,228,125,103
2018,7 - 27 días,Dificultad respiratoria del recién nacido,136,73,63
2018,7 - 27 días,Enterocolitis necrotizante del feto y del recién nacido,61,31,30
2018,7 - 27 días,Trastornos cardiovasculares originados en el período perinatal,60,32,28
2018,7 - 27 días,Coagulación intravascular diseminada en el feto y el recién nacido,59,31,28
2018,7 - 27 días,Otras malformaciones congénitas del corazón,57,33,24
2018,7 - 27 días,Síndromes de aspiración neonatal,41,27,14
2018,7 - 27 días,"Trastornos relacionados con duración corta de la gestación y con bajo peso al nacer, no clasificados en otra parte",40,25,15
2018,7 - 27 días,"Otras malformaciones congénitas, no clasificadas en otra parte",29,17,12
2018,7 - 27 días,Hemorragia pulmonar originada en el período perinatal,28,15,13
2018,7 - 27 días,Asfixia del nacimiento,27,20,7
2018,7 - 27 días,Otras hemorragias neonatales,27,16,11
2018,7 - 27 días,Otros trastornos perinatales del sistema digestivo,27,19,8
2018,7 - 27 días,"Otros problemas respiratorios del recién nacido, originados en el período perinatal",24,10,14
2018,7 - 27 días,"Síntomas, signos y hallazgos anormales clínicos y de laboratorio, no clasificados en otra parte",114,68,46
2018,7 - 27 días,Otras causas,267,164,103
2018,28 días a menos de 1 año,"Neumonía, organismo no especificado",937,528,409
2018,28 días a menos de 1 año,Otras gastroenteritis y colitis de origen infeccioso y no especificado,281,156,125
2018,28 días a menos de 1 año,Otras sepsis,219,136,83
2018,28 días a menos de 1 año,Otras malformaciones congénitas del corazón,191,97,94
2018,28 días a menos de 1 año,"Neumonía bacteriana, no clasificada en otra parte",78,46,32
2018,28 días a menos de 1 año,Coagulación intravascular diseminada [síndrome de desfibrinación],76,43,33
2018,28 días a menos de 1 año,Otros trastornos respiratorios,56,27,29
2018,28 días a menos de 1 año,Obstrucción no especificada de la respiración,50,29,21
2018,28 días a menos de 1 año,"Otros trastornos de los líquidos, de los electrólitos y del equilibrio ácido-básico",49,32,17
2018,28 días a menos de 1 año,Síndrome de dificultad respiratoria del adulto,41,25,16
2018,28 días a menos de 1 año,"Desnutrición proteicocalórica severa, no especificada",40,21,19
2018,28 días a menos de 1 año,"Desnutrición proteicocalórica, no especificada",40,20,20
2018,28 días a menos de 1 año,Hidrocéfalo,38,21,17
2018,28 días a menos de 1 año,Depleción del volumen,36,15,21
2018,28 días a menos de 1 año,Neumotórax,32,17,15
2018,28 días a menos de 1 año,"Síntomas, signos y hallazgos anormales clínicos y de laboratorio, no clasificados en otra parte",495,274,221
2018,28 días a menos de 1 año,Otras causas,956,555,401
2018,1 año,"Neumonía, organismo no especificado",276,137,139
2018,1 año,Otras gastroenteritis y colitis de origen infeccioso y no especificado,223,126,97
2018,1 año,Otras sepsis,48,25,23
2018,1 año,Otras malformaciones congénitas del corazón,32,13,19
2018,1 año,"Neumonía bacteriana, no clasificada en otra parte",28,15,13
2018,1 año,Obstrucción no especificada de la respiración,24,14,10
2018,1 año,"Desnutrición proteicocalórica severa, no especificada",23,12,11
2018,1 año,"Otros trastornos de los líquidos, de los electrólitos y del equilibrio ácido-básico",22,11,11
2018,1 año,Depleción del volumen,21,11,10
2018,1 año,Exposición a factores no especificados,18,10,8
2018,1 año,Epilepsia,16,9,7
2018,1 año,"Desnutrición proteicocalórica, no especificada",15,8,7
2018,1 año,Ahogamiento y sumersión no especificados,15,13,2
2018,1 año,Asma,12,4,8
2018,1 año,Ileo paralítico y obstrucción intestinal sin hernia,11,5,6
2018,1 año,"Síntomas, signos y hallazgos anormales clínicos y de laboratorio, no clasificados en otra parte",151,85,66
2018,1 año,Otras causas,297,159,138
2018,2 años,"Neumonía, organismo no especificado",96,45,51
2018,2 años,Otras gastroenteritis y colitis de origen infeccioso y no especificado,68,37,31
2018,2 años,Exposición a factores no especificados,18,8,10
2018,2 años,Otras sepsis,13,7,6
2018,2 años,Obstrucción no especificada de la respiración,12,6,6
2018,2 años,Ahogamiento y sumersión no especificados,11,8,3
2018,2 años,"Exposición a humos, fuegos o llamas no especificados",11,4,7
2018,2 años,Otros síndromes paralíticos,8,6,2
2018,2 años,Otras malformaciones congénitas del corazón,8,3,5
2018,2 años,Coagulación intravascular diseminada [síndrome de desfibrinación],6,4,2
2018,2 años,"Desnutrición proteicocalórica severa, no especificada",6,3,3
2018,2 años,Epilepsia,6,3,3
2018,2 años,"Neumonía bacteriana, no clasificada en otra parte",6,2,4
2018,2 años,"Accidente de vehículo de motor o sin motor, tipo de vehículo no especificado",6,3,3
2018,2 años,"Síntomas, signos y hallazgos anormales clínicos y de laboratorio, no clasificados en otra parte",55,23,32
2018,2 años,Otras causas,123,70,53
2018,3 años,"Neumonía, organismo no especificado",46,24,22
2018,3 años,Otras gastroenteritis y colitis de origen infeccioso y no especificado,29,15,14
2018,3 años,Exposición a factores no especificados,14,7,7
2018,3 años,Ahogamiento y sumersión no especificados,9,5,4
2018,3 años,"Exposición a humos, fuegos o llamas no especificados",8,7,1
2018,3 años,Otras sepsis,6,4,2
2018,3 años,Depleción del volumen,6,4,2
2018,3 años,Otras malformaciones congénitas del corazón,6,3,3
2018,3 años,"Desnutrición proteicocalórica severa, no especificada",5,3,2
2018,3 años,Leucemia linfoide,4,3,1
2018,3 años,Coagulación intravascular diseminada [síndrome de desfibrinación],4,3,1
2018,3 años,Parálisis cerebral,4,3,1
2018,3 años,"Accidente de vehículo de motor o sin motor, tipo de vehículo no especificado",4,1,3
2018,3 años,Obstrucción no especificada de la respiración,4,2,2
2018,3 años,"Síntomas, signos y hallazgos anormales clínicos y de laboratorio, no clasificados en otra parte",26,13,13
2018,3 años,Otras causas,85,45,40
2018,4 años,"Neumonía, organismo no especificado",29,16,13
2018,4 años,Otras gastroenteritis y colitis de origen infeccioso y no especificado,12,5,7
2018,4 años,"Exposición a humos, fuegos o llamas no especificados",12,6,6
2018,4 años,"Accidente de vehículo de motor o sin motor, tipo de vehículo no especificado",9,5,4
2018,4 años,Exposición a factores no especificados,8,4,4
2018,4 años,Otras sepsis,7,4,3
2018,4 años,Hidrocéfalo,5,3,2
2018,4 años,Leucemia linfoide,3,1,2
2018,4 años,Fibrosis quística,3,1,2
2018,4 años,Neumonitis debida a sólidos y líquidos,3,1,2
2018,4 años,Otros trastornos respiratorios,3,2,1
2018,4 años,"Síntomas, signos y hallazgos anormales clínicos y de laboratorio, no clasificados en otra parte",27,19,8
2018,4 años,Otras causas,69,39,30
2018,5 - 9 años,"Neumonía, organismo no especificado",80,44,36
2018,5 - 9 años,Otras gastroenteritis y colitis de origen infeccioso y no especificado,66,32,34
2018,5 - 9 años,Exposición a factores no especificados,48,36,12
2018,5 - 9 años,"Accidente de vehículo de motor o sin motor, tipo de vehículo no especificado",30,19,11
2018,5 - 9 años,Leucemia linfoide,22,13,9
2018,5 - 9 años,Otras sepsis,19,7,12
2018,5 - 9 años,"Exposición a humos, fuegos o llamas no especificados",19,9,10
2018,5 - 9 años,Otros trastornos del encéfalo,16,10,6
2018,5 - 9 años,Parálisis cerebral,13,9,4
2018,5 - 9 años,Obstrucción no especificada de la respiración,13,7,6
2018,5 - 9 años,Tumor maligno del encéfalo,12,4,8
2018,5 - 9 años,Ahogamiento y sumersión no especificados,11,9,2
2018,5 - 9 años,Coagulación intravascular diseminada [síndrome de desfibrinación],9,5,4
2018,5 - 9 años,Hidrocéfalo,9,3,6
2018,5 - 9 años,Otros trastornos respiratorios,8,4,4
2018,5 - 9 años,"Síntomas, signos y hallazgos anormales clínicos y de laboratorio, no clasificados en otra parte",63,36,27
2018,5 - 9 años,Otras causas,273,132,141
2018,10 - 14 años,"Neumonía, organismo no especificado",58,40,18
2018,10 - 14 años,Exposición a factores no especificados,52,31,21
2018,10 - 14 años,"Agresión con disparo de otras armas de fuego, y las no especificadas",39,28,11
2018,10 - 14 años,"Accidente de vehículo de motor o sin motor, tipo de vehículo no especificado",31,19,12
2018,10 - 14 años,Leucemia linfoide,26,13,13
2018,10 - 14 años,Otros estrangulamientos y ahorcamientos accidentales,23,11,12
2018,10 - 14 años,Otras gastroenteritis y colitis de origen infeccioso y no especificado,22,10,12
2018,10 - 14 años,"Exposición a humos, fuegos o llamas no especificados",21,5,16
2018,10 - 14 años,Ahogamiento y sumersión no especificados,19,13,6
2018,10 - 14 años,Epilepsia,18,11,7
2018,10 - 14 años,Enfermedad renal crónica,16,8,8
2018,10 - 14 años,"Disparo de otras armas de fuego, y las no especificadas",15,10,5
2018,10 - 14 años,Otros trastornos del encéfalo,12,6,6
2018,10 - 14 años,Complicaciones y descripciones mal definidas de enfermedad cardíaca,12,7,5
2018,10 - 14 años,"Lesión autoinfligida intencionalmente por ahorcamiento, estrangulamiento o sofocación",11,7,4
2018,10 - 14 años,"Síntomas, signos y hallazgos anormales clínicos y de laboratorio, no clasificados en otra parte",89,37,52
2018,10 - 14 años,Otras causas,305,155,150
2018,15 - 19 años,"Agresión con disparo de otras armas de fuego, y las no especificadas",432,370,62
2018,15 - 19 años,Exposición a factores no especificados,173,149,24
2018,15 - 19 años,"Accidente de vehículo de motor o sin motor, tipo de vehículo no especificado",144,119,25
2018,15 - 19 años,"Disparo de otras armas de fuego, y las no especificadas",114,99,15
2018,15 - 19 años,"Neumonía, organismo no especificado",65,39,26
2018,15 - 19 años,"Lesión autoinfligida intencionalmente por ahorcamiento, estrangulamiento o sofocación",53,35,18
2018,15 - 19 años,Otros estrangulamientos y ahorcamientos accidentales,48,34,14
2018,15 - 19 años,Ahogamiento y sumersión no especificados,40,33,7
2018,15 - 19 años,Enfermedad renal crónica,37,20,17
2018,15 - 19 años,"Agresión por ahorcamiento, estrangulamiento y sofocación",35,17,18
2018,15 - 19 años,Otras gastroenteritis y colitis de origen infeccioso y no especificado,34,24,10
2018,15 - 19 años,Leucemia linfoide,31,19,12
2018,15 - 19 años,"Exposición a humos, fuegos o llamas no especificados",30,18,12
2018,15 - 19 años,"Envenenamiento autoinfligido intencionalmente por, y exposición a plaguicidas",30,14,16
2018,15 - 19 años,Infarto agudo del miocardio,27,18,9
2018,15 - 19 años,"Síntomas, signos y hallazgos anormales clínicos y de laboratorio, no clasificados en otra parte",139,80,59
2018,15 - 19 años,Otras causas,662,369,293
2018,20 - 24 años,"Agresión con disparo de otras armas de fuego, y las no especificadas",502,452,50
2018,20 - 24 años,Exposición a factores no especificados,308,283,25
2018,20 - 24 años,"Accidente de vehículo de motor o sin motor, tipo de vehículo no especificado",262,233,29
2018,20 - 24 años,"Disparo de otras armas de fuego, y las no especificadas",166,147,19
2018,20 - 24 años,"Neumonía, organismo no especificado",63,39,24
2018,20 - 24 años,Enfermedad renal crónica,54,31,23
2018,20 - 24 años,Otros estrangulamientos y ahorcamientos accidentales,49,40,9
2018,20 - 24 años,Agresión por medios no especificados,45,39,6
2018,20 - 24 años,"Lesión autoinfligida intencionalmente por ahorcamiento, estrangulamiento o sofocación",44,37,7
2018,20 - 24 años,Agresión con objeto cortante,44,35,9
2018,20 - 24 años,Infarto agudo del miocardio,43,24,19
2018,20 - 24 años,Ahogamiento y sumersión no especificados,39,37,2
2018,20 - 24 años,"Envenenamiento accidental por, y exposición al alcohol",35,34,1
2018,20 - 24 años,Otras gastroenteritis y colitis de origen infeccioso y no especificado,30,16,14
2018,20 - 24 años,"Exposición a humos, fuegos o llamas no especificados",27,12,15
2018,20 - 24 años,"Síntomas, signos y hallazgos anormales clínicos y de laboratorio, no clasificados en otra parte",184,110,74
2018,20 - 24 años,Otras causas,916,533,383
2018,25 - 29 años,"Agresión con disparo de otras armas de fuego, y las no especificadas",417,384,33
2018,25 - 29 años,Exposición a factores no especificados,311,273,38
2018,25 - 29 años,"Accidente de vehículo de motor o sin motor, tipo de vehículo no especificado",238,217,21
2018,25 - 29 años,"Disparo de otras armas de fuego, y las no especificadas",110,103,7
2018,25 - 29 años,"Neumonía, organismo no especificado",69,42,27
2018,25 - 29 años,Infarto agudo del miocardio,56,44,12
2018,25 - 29 años,"Envenenamiento accidental por, y exposición al alcohol",51,47,4
2018,25 - 29 años,Fibrosis y cirrosis del hígado,46,39,7
2018,25 - 29 años,Otros estrangulamientos y ahorcamientos accidentales,38,34,4
2018,25 - 29 años,Otras gastroenteritis y colitis de origen infeccioso y no especificado,34,12,22
2018,25 - 29 años,Agresión con objeto cortante,34,30,4
2018,25 - 29 años,"Lesión autoinfligida intencionalmente por ahorcamiento, estrangulamiento o sofocación",33,30,3
2018,25 - 29 años,Agresión por medios no especificados,29,24,5
2018,25 - 29 años,Trastornos mentales y del comportamiento debidos al uso de alcohol,27,24,3
2018,25 - 29 años,Ahogamiento y sumersión no especificados,27,26,1
2018,25 - 29 años,"Síntomas, signos y hallazgos anormales clínicos y de laboratorio, no clasificados en otra parte",182,124,58
2018,25 - 29 años,Otras causas,948,537,411
2018,30 - 34 años,"Agresión con disparo de otras armas de fuego, y las no especificadas",311,268,43
2018,30 - 34 años,Exposición a factores no especificados,213,193,20
2018,30 - 34 años,"Accidente de vehículo de motor o sin motor, tipo de vehículo no especificado",175,156,19
2018,30 - 34 años,Fibrosis y cirrosis del hígado,98,82,16
2018,30 - 34 años,"Disparo de otras armas de fuego, y las no especificadas",97,87,10
2018,30 - 34 años,"Neumonía, organismo no especificado",80,52,28
2018,30 - 34 años,"Envenenamiento accidental por, y exposición al alcohol",66,59,7
2018,30 - 34 años,"Diabetes mellitus, no especificada",63,32,31
2018,30 - 34 años,Infarto agudo del miocardio,57,37,20
2018,30 - 34 años,Enfermedad alcohólica del hígado,57,52,5
2018,30 - 34 años,Trastornos mentales y del comportamiento debidos al uso de alcohol,37,35,2
2018,30 - 34 años,Enfermedad renal crónica,36,21,15
2018,30 - 34 años,"Lesión autoinfligida intencionalmente por ahorcamiento, estrangulamiento o sofocación",35,25,10
2018,30 - 34 años,"Accidente vascular encefálico agudo, no especificado como hemorrágico o isquémico",28,8,20
2018,30 - 34 años,Ahogamiento y sumersión no especificados,28,26,2
2018,30 - 34 años,"Síntomas, signos y hallazgos anormales clínicos y de laboratorio, no clasificados en otra parte",220,138,82
2018,30 - 34 años,Otras causas,947,529,418
2018,35 - 39 años,"Agresión con disparo de otras armas de fuego, y las no especificadas",295,257,38
2018,35 - 39 años,Exposición a factores no especificados,219,191,28
2018,35 - 39 años,Fibrosis y cirrosis del hígado,151,131,20
2018,35 - 39 años,"Accidente de vehículo de motor o sin motor, tipo de vehículo no especificado",132,109,23
2018,35 - 39 años,"Envenenamiento accidental por, y exposición al alcohol",110,100,10
2018,35 - 39 años,"Diabetes mellitus, no especificada",106,62,44
2018,35 - 39 años,"Neumonía, organismo no especificado",93,51,42
2018,35 - 39 años,Enfermedad alcohólica del hígado,93,84,9
2018,35 - 39 años,Infarto agudo del miocardio,87,51,36
2018,35 - 39 años,"Disparo de otras armas de fuego, y las no especificadas",79,73,6
2018,35 - 39 años,Enfermedad renal crónica,50,26,24
2018,35 - 39 años,Trastornos mentales y del comportamiento debidos al uso de alcohol,49,44,5
2018,35 - 39 años,Tumor maligno del estómago,39,19,20
2018,35 - 39 años,Otras gastroenteritis y colitis de origen infeccioso y no especificado,35,24,11
2018,35 - 39 años,"Síntomas, signos y hallazgos anormales clínicos y de laboratorio, no clasificados en otra parte",231,143,88
2018,35 - 39 años,Otras causas,1213,665,548
2018,40 - 44 años,Fibrosis y cirrosis del hígado,209,161,48
2018,40 - 44 años,"Agresión con disparo de otras armas de fuego, y las no especificadas",205,176,29
2018,40 - 44 años,Exposición a factores no especificados,186,158,28
2018,40 - 44 años,"Diabetes mellitus, no especificada",153,61,92
2018,40 - 44 años,Infarto agudo del miocardio,127,78,49
2018,40 - 44 años,"Accidente de vehículo de motor o sin motor, tipo de vehículo no especificado",115,94,21
2018,40 - 44 años,"Neumonía, organismo no especificado",108,60,48
2018,40 - 44 años,"Envenenamiento accidental por, y exposición al alcohol",92,82,10
2018,40 - 44 años,Enfermedad renal crónica,80,45,35
2018,40 - 44 años,Enfermedad alcohólica del hígado,67,61,6
2018,40 - 44 años,Diabetes mellitus no insulinodependiente,62,30,32
2018,40 - 44 años,Trastornos mentales y del comportamiento debidos al uso de alcohol,57,47,10
2018,40 - 44 años,Tumor maligno del estómago,50,13,37
2018,40 - 44 años,Otras enfermedades del sistema digestivo,47,30,17
2018,40 - 44 años,Otras gastroenteritis y colitis de origen infeccioso y no especificado,43,25,18
2018,40 - 44 años,"Síntomas, signos y hallazgos anormales clínicos y de laboratorio, no clasificados en otra parte",307,198,109
2018,40 - 44 años,Otras causas,1236,658,578
2018,45 - 49 años,"Diabetes mellitus, no especificada",262,115,147
2018,45 - 49 años,Fibrosis y cirrosis del hígado,232,174,58
2018,45 - 49 años,Infarto agudo del miocardio,160,103,57
2018,45 - 49 años,Exposición a factores no especificados,152,136,16
2018,45 - 49 años,"Agresión con disparo de otras armas de fuego, y las no especificadas",127,109,18
2018,45 - 49 años,Diabetes mellitus no insulinodependiente,114,51,63
2018,45 - 49 años,"Neumonía, organismo no especificado",113,58,55
2018,45 - 49 años,Enfermedad alcohólica del hígado,104,88,16
2018,45 - 49 años,"Accidente de vehículo de motor o sin motor, tipo de vehículo no especificado",89,70,19
2018,45 - 49 años,"Envenenamiento accidental por, y exposición al alcohol",76,70,6
2018,45 - 49 años,Trastornos mentales y del comportamiento debidos al uso de alcohol,71,67,4
2018,45 - 49 años,Enfermedad renal crónica,71,38,33
2018,45 - 49 años,Tumor maligno del estómago,66,25,41
2018,45 - 49 años,Insuficiencia renal no especificada,53,29,24
2018,45 - 49 años,"Síntomas, signos y hallazgos anormales clínicos y de laboratorio, no clasificados en otra parte",309,178,131
2018,45 - 49 años,Otras causas,127,671,599
2018,50 - 54 años,"Diabetes mellitus, no especificada",355,145,210
2018,50 - 54 años,Fibrosis y cirrosis del hígado,247,181,66
2018,50 - 54 años,Infarto agudo del miocardio,212,128,84
2018,50 - 54 años,"Neumonía, organismo no especificado",165,95,70
2018,50 - 54 años,Diabetes mellitus no insulinodependiente,155,54,101
2018,50 - 54 años,Exposición a factores no especificados,146,126,20
2018,50 - 54 años,Enfermedad renal crónica,129,59,70
2018,50 - 54 años,"Agresión con disparo de otras armas de fuego, y las no especificadas",92,71,21
2018,50 - 54 años,Tumor maligno del estómago,78,42,36
2018,50 - 54 años,Tumor maligno del hígado y de las vías biliares intrahepáticas,78,33,45
2018,50 - 54 años,Enfermedad alcohólica del hígado,76,61,15
2018,50 - 54 años,"Envenenamiento accidental por, y exposición al alcohol",76,71,5
2018,50 - 54 años,"Accidente de vehículo de motor o sin motor, tipo de vehículo no especificado",69,55,14
2018,50 - 54 años,Insuficiencia renal no especificada,60,39,21
2018,50 - 54 años,"Accidente vascular encefálico agudo, no especificado como hemorrágico o isquémico",52,29,23
2018,50 - 54 años,"Síntomas, signos y hallazgos anormales clínicos y de laboratorio, no clasificados en otra parte",358,189,169
2018,50 - 54 años,Otras causas,1522,797,725
2018,55 - 59 años,"Diabetes mellitus, no especificada",547,219,328
2018,55 - 59 años,Fibrosis y cirrosis del hígado,343,213,130
2018,55 - 59 años,Infarto agudo del miocardio,287,164,123
2018,55 - 59 años,Diabetes mellitus no insulinodependiente,197,72,125
2018,55 - 59 años,"Neumonía, organismo no especificado",188,100,88
2018,55 - 59 años,Enfermedad renal crónica,156,64,92
2018,55 - 59 años,Tumor maligno del hígado y de las vías biliares intrahepáticas,127,56,71
2018,55 - 59 años,Exposición a factores no especificados,116,94,22
2018,55 - 59 años,Tumor maligno del estómago,96,46,50
2018,55 - 59 años,Insuficiencia renal no especificada,81,56,25
2018,55 - 59 años,"Agresión con disparo de otras armas de fuego, y las no especificadas",75,60,15
2018,55 - 59 años,Otras gastroenteritis y colitis de origen infeccioso y no especificado,74,34,40
2018,55 - 59 años,"Accidente de vehículo de motor o sin motor, tipo de vehículo no especificado",69,53,16
2018,55 - 59 años,Insuficiencia cardíaca,68,30,38
2018,55 - 59 años,"Accidente vascular encefálico agudo, no especificado como hemorrágico o isquémico",68,35,33
2018,55 - 59 años,"Síntomas, signos y hallazgos anormales clínicos y de laboratorio, no clasificados en otra parte",503,280,223
2018,55 - 59 años,Otras causas,1724,905,819
2018,60 - 64 años,"Diabetes mellitus, no especificada",672,256,416
2018,60 - 64 años,Infarto agudo del miocardio,371,214,157
2018,60 - 64 años,Fibrosis y cirrosis del hígado,328,179,149
2018,60 - 64 años,"Neumonía, organismo no especificado",274,124,150
2018,60 - 64 años,Diabetes mellitus no insulinodependiente,209,93,116
2018,60 - 64 años,Tumor maligno del hígado y de las vías biliares intrahepáticas,180,71,109
2018,60 - 64 años,Enfermedad renal crónica,170,74,96
2018,60 - 64 años,Tumor maligno del estómago,139,77,62
2018,60 - 64 años,Exposición a factores no especificados,132,105,27
2018,60 - 64 años,Insuficiencia renal no especificada,113,55,58
2018,60 - 64 años,"Accidente vascular encefálico agudo, no especificado como hemorrágico o isquémico",108,53,55
2018,60 - 64 años,Otras gastroenteritis y colitis de origen infeccioso y no especificado,87,40,47
2018,60 - 64 años,Otras enfermedades del sistema digestivo,74,37,37
2018,60 - 64 años,Insuficiencia cardíaca,69,26,43
2018,60 - 64 años,Enfermedad alcohólica del hígado,59,53,6
2018,60 - 64 años,"Síntomas, signos y hallazgos anormales clínicos y de laboratorio, no clasificados en otra parte",553,287,266
2018,60 - 64 años,Otras causas,1997,1042,955
2018,65 - 69 años,"Diabetes mellitus, no especificada",649,261,388
2018,65 - 69 años,Infarto agudo del miocardio,468,269,199
2018,65 - 69 años,"Neumonía, organismo no especificado",343,173,170
2018,65 - 69 años,Fibrosis y cirrosis del hígado,317,165,152
2018,65 - 69 años,Tumor maligno del hígado y de las vías biliares intrahepáticas,243,124,119
2018,65 - 69 años,Diabetes mellitus no insulinodependiente,225,96,129
2018,65 - 69 años,Enfermedad renal crónica,196,99,97
2018,65 - 69 años,Tumor maligno del estómago,149,64,85
2018,65 - 69 años,"Accidente vascular encefálico agudo, no especificado como hemorrágico o isquémico",143,73,70
2018,65 - 69 años,Insuficiencia renal no especificada,134,65,69
2018,65 - 69 años,Insuficiencia cardíaca,125,64,61
2018,65 - 69 años,Exposición a factores no especificados,110,88,22
2018,65 - 69 años,Otras gastroenteritis y colitis de origen infeccioso y no especificado,105,57,48
2018,65 - 69 años,Otras enfermedades cerebrovasculares,74,36,38
2018,65 - 69 años,Hipertensión esencial (primaria),70,29,41
2018,65 - 69 años,"Síntomas, signos y hallazgos anormales clínicos y de laboratorio, no clasificados en otra parte",752,373,379
2018,65 - 69 años,Otras causas,2133,1143,990
2018,70 - 74 años,"Diabetes mellitus, no especificada",605,204,401
2018,70 - 74 años,Infarto agudo del miocardio,580,332,248
2018,70 - 74 años,"Neumonía, organismo no especificado",428,212,216
2018,70 - 74 años,Tumor maligno del hígado y de las vías biliares intrahepáticas,249,128,121
2018,70 - 74 años,Fibrosis y cirrosis del hígado,237,129,108
2018,70 - 74 años,"Accidente vascular encefálico agudo, no especificado como hemorrágico o isquémico",201,99,102
2018,70 - 74 años,Diabetes mellitus no insulinodependiente,191,69,122
2018,70 - 74 años,Enfermedad renal crónica,158,85,73
2018,70 - 74 años,Tumor maligno del estómago,146,71,75
2018,70 - 74 años,Insuficiencia cardíaca,125,59,66
2018,70 - 74 años,Insuficiencia renal no especificada,115,52,63
2018,70 - 74 años,Exposición a factores no especificados,111,67,44
2018,70 - 74 años,Otras gastroenteritis y colitis de origen infeccioso y no especificado,104,56,48
2018,70 - 74 años,Otras enfermedades pulmonares obstructivas crónicas,104,48,56
2018,70 - 74 años,Otras enfermedades cerebrovasculares,79,38,41
2018,70 - 74 años,"Síntomas, signos y hallazgos anormales clínicos y de laboratorio, no clasificados en otra parte",849,456,393
2018,70 - 74 años,Otras causas,2163,1131,1032
2018,75 - 79 años,Infarto agudo del miocardio,633,325,308
2018,75 - 79 años,"Neumonía, organismo no especificado",536,292,244
2018,75 - 79 años,"Diabetes mellitus, no especificada",461,165,296
2018,75 - 79 años,"Accidente vascular encefálico agudo, no especificado como hemorrágico o isquémico",212,110,102
2018,75 - 79 años,Tumor maligno del hígado y de las vías biliares intrahepáticas,199,99,100
2018,75 - 79 años,Diabetes mellitus no insulinodependiente,170,62,108
2018,75 - 79 años,Insuficiencia cardíaca,159,80,79
2018,75 - 79 años,Fibrosis y cirrosis del hígado,153,76,77
2018,75 - 79 años,Tumor maligno del estómago,149,69,80
2018,75 - 79 años,Enfermedad renal crónica,132,75,57
2018,75 - 79 años,Otras enfermedades pulmonares obstructivas crónicas,112,58,54
2018,75 - 79 años,Insuficiencia renal no especificada,107,49,58
2018,75 - 79 años,Otras gastroenteritis y colitis de origen infeccioso y no especificado,106,46,60
2018,75 - 79 años,Exposición a factores no especificados,93,53,40
2018,75 - 79 años,"Síntomas, signos y hallazgos anormales clínicos y de laboratorio, no clasificados en otra parte",1008,485,523
2018,75 - 79 años,Otras causas,2064,1051,1013
2018,80 - 84 años,Infarto agudo del miocardio,801,398,403
2018,80 - 84 años,"Neumonía, organismo no especificado",722,368,354
2018,80 - 84 años,"Diabetes mellitus, no especificada",363,133,230
2018,80 - 84 años,"Accidente vascular encefálico agudo, no especificado como hemorrágico o isquémico",243,130,113
2018,80 - 84 años,Insuficiencia cardíaca,214,105,109
2018,80 - 84 años,Otras enfermedades pulmonares obstructivas crónicas,140,70,70
2018,80 - 84 años,Diabetes mellitus no insulinodependiente,134,53,81
2018,80 - 84 años,Otras gastroenteritis y colitis de origen infeccioso y no especificado,133,66,67
2018,80 - 84 años,Tumor maligno del hígado y de las vías biliares intrahepáticas,132,71,61
2018,80 - 84 años,Otras enfermedades cerebrovasculares,129,48,81
2018,80 - 84 años,Tumor maligno del estómago,127,61,66
2018,80 - 84 años,Hipertensión esencial (primaria),123,54,69
2018,80 - 84 años,Enfermedad renal crónica,107,61,46
2018,80 - 84 años,Fibrosis y cirrosis del hígado,100,45,55
2018,80 - 84 años,"Síntomas, signos y hallazgos anormales clínicos y de laboratorio, no clasificados en otra parte",1242,596,646
2018,80 - 84 años,Otras causas,2056,1005,1051
2018,85 y más,Infarto agudo del miocardio,1605,772,833
2018,85 y más,"Neumonía, organismo no especificado",1461,744,717
2018,85 y más,"Accidente vascular encefálico agudo, no especificado como hemorrágico o isquémico",482,223,259
2018,85 y más,Insuficiencia cardíaca,476,216,260
2018,85 y más,"Diabetes mellitus, no especificada",344,127,217
2018,85 y más,Otras enfermedades pulmonares obstructivas crónicas,276,142,134
2018,85 y más,"Desnutrición proteicocalórica, no especificada",259,110,149
2018,85 y más,Hipertensión esencial (primaria),258,93,165
2018,85 y más,Otras gastroenteritis y colitis de origen infeccioso y no especificado,206,84,122
2018,85 y más,Otras enfermedades cerebrovasculares,167,85,82
2018,85 y más,Exposición a factores no especificados,163,77,86
2018,85 y más,Enfermedad renal crónica,155,91,64
2018,85 y más,Diabetes mellitus no insulinodependiente,146,45,101
2018,85 y más,Tumor maligno del estómago,133,51,82
2018,85 y más,"Síntomas, signos y hallazgos anormales clínicos y de laboratorio, no clasificados en otra parte",2653,1255,1398
2018,85 y más,Otras causas,293,1305,1625
2019,1- 6 días,Dificultad respiratoria del recién nacido,395,245,150
2019,1- 6 días,Sepsis bacteriana del recién nacido,198,109,89
2019,1- 6 días,Neumonía congénita,153,89,64
2019,1- 6 días,Asfixia del nacimiento,130,71,59
2019,1- 6 días,Síndromes de aspiración neonatal,128,79,49
2019,1- 6 días,Trastornos cardiovasculares originados en el período perinatal,89,51,38
2019,1- 6 días,Otras malformaciones congénitas del corazón,74,46,28
2019,1- 6 días,"Otras malformaciones congénitas, no clasificadas en otra parte",68,36,32
2019,1- 6 días,"Trastornos relacionados con duración corta de la gestación y con bajo peso al nacer, no clasificados en otra parte",61,36,25
2019,1- 6 días,Coagulación intravascular diseminada en el feto y el recién nacido,35,14,21
2019,1- 6 días,Hemorragia pulmonar originada en el período perinatal,34,22,12
2019,1- 6 días,Hernia diafragmática,25,12,13
2019,1- 6 días,"Otros problemas respiratorios del recién nacido, originados en el período perinatal",24,17,7
2019,1- 6 días,"Enfisema intersticial y afecciones relacionadas, originadas en el período perinatal",21,15,6
2019,1- 6 días,Hemorragia intracraneal no traumática del feto y del recién nacido,20,11,9
2019,1- 6 días,"Síntomas, signos y hallazgos anormales clínicos y de laboratorio, no clasificados en otra parte",71,34,37
2019,1- 6 días,Otras causas,276,157,119
2019,7 - 27 días,Sepsis bacteriana del recién nacido,217,127,90
2019,7 - 27 días,Neumonía congénita,193,108,85
2019,7 - 27 días,Dificultad respiratoria del recién nacido,114,56,58
2019,7 - 27 días,Otras malformaciones congénitas del corazón,68,42,26
2019,7 - 27 días,Síndromes de aspiración neonatal,56,34,22
2019,7 - 27 días,"Trastornos relacionados con duración corta de la gestación y con bajo peso al nacer, no clasificados en otra parte",54,29,25
2019,7 - 27 días,Coagulación intravascular diseminada en el feto y el recién nacido,50,24,26
2019,7 - 27 días,Enterocolitis necrotizante del feto y del recién nacido,46,26,20
2019,7 - 27 días,Asfixia del nacimiento,45,29,16
2019,7 - 27 días,Trastornos cardiovasculares originados en el período perinatal,39,17,22
2019,7 - 27 días,"Otras malformaciones congénitas, no clasificadas en otra parte",37,15,22
2019,7 - 27 días,Hemorragia pulmonar originada en el período perinatal,30,18,12
2019,7 - 27 días,"Otros problemas respiratorios del recién nacido, originados en el período perinatal",22,14,8
2019,7 - 27 días,Otros trastornos perinatales del sistema digestivo,20,12,8
2019,7 - 27 días,Hemorragia intracraneal no traumática del feto y del recién nacido,19,13,6
2019,7 - 27 días,"Síntomas, signos y hallazgos anormales clínicos y de laboratorio, no clasificados en otra parte",73,41,32
2019,7 - 27 días,Otras causas,277,154,123
2019,28 días a menos de 1 año,"Neumonía, organismo no especificado",876,478,398
2019,28 días a menos de 1 año,Otras gastroenteritis y colitis de origen infeccioso y no especificado,349,199,150
2019,28 días a menos de 1 año,Otras malformaciones congénitas del corazón,195,100,95
2019,28 días a menos de 1 año,Otras sepsis,173,107,66
2019,28 días a menos de 1 año,Coagulación intravascular diseminada [síndrome de desfibrinación],59,32,27
2019,28 días a menos de 1 año,"Desnutrición proteicocalórica severa, no especificada",57,30,27
2019,28 días a menos de 1 año,"Neumonía bacteriana, no clasificada en otra parte",52,30,22
2019,28 días a menos de 1 año,Síndrome de dificultad respiratoria del adulto,49,26,23
2019,28 días a menos de 1 año,Malformaciones congénitas del pulmón,47,18,29
2019,28 días a menos de 1 año,Síndrome de Down,41,21,20
2019,28 días a menos de 1 año,"Desnutrición proteicocalórica, no especificada",39,24,15
2019,28 días a menos de 1 año,Obstrucción no especificada de la respiración,39,23,16
2019,28 días a menos de 1 año,Otros trastornos respiratorios,38,20,18
2019,28 días a menos de 1 año,Depleción del volumen,36,26,10
2019,28 días a menos de 1 año,"Otras malformaciones congénitas, no clasificadas en otra parte",35,21,14
2019,28 días a menos de 1 año,"Síntomas, signos y hallazgos anormales clínicos y de laboratorio, no clasificados en otra parte",428,219,209
2019,28 días a menos de 1 año,Otras causas,1029,559,470
2019,1 año,"Neumonía, organismo no especificado",260,135,125
2019,1 año,Otras gastroenteritis y colitis de origen infeccioso y no especificado,259,133,126
2019,1 año,Otras sepsis,36,24,12
2019,1 año,"Desnutrición proteicocalórica severa, no especificada",31,18,13
2019,1 año,"Neumonía bacteriana, no clasificada en otra parte",23,14,9
2019,1 año,Otras malformaciones congénitas del corazón,23,15,8
2019,1 año,"Desnutrición proteicocalórica, no especificada",22,10,12
2019,1 año,Coagulación intravascular diseminada [síndrome de desfibrinación],21,7,14
2019,1 año,"Otros trastornos de los líquidos, de los electrólitos y del equilibrio ácido-básico",21,15,6
2019,1 año,Depleción del volumen,16,5,11
2019,1 año,Obstrucción no especificada de la respiración,16,8,8
2019,1 año,Exposición a factores no especificados,14,7,7
2019,1 año,Otras infecciones intestinales bacterianas,12,4,8
2019,1 año,Parálisis cerebral,12,7,5
2019,1 año,Epilepsia,11,8,3
2019,1 año,"Síntomas, signos y hallazgos anormales clínicos y de laboratorio, no clasificados en otra parte",146,76,70
2019,1 año,Otras causas,289,159,130
2019,2 años,"Neumonía, organismo no especificado",93,46,47
2019,2 años,Otras gastroenteritis y colitis de origen infeccioso y no especificado,88,52,36
2019,2 años,"Desnutrición proteicocalórica severa, no especificada",15,8,7
2019,2 años,"Accidente de vehículo de motor o sin motor, tipo de vehículo no especificado",13,6,7
2019,2 años,Parálisis cerebral,12,6,6
2019,2 años,Exposición a factores no especificados,12,9,3
2019,2 años,Otras sepsis,10,5,5
2019,2 años,Otros trastornos respiratorios,10,6,4
2019,2 años,"Exposición a humos, fuegos o llamas no especificados",10,6,4
2019,2 años,"Neumonía bacteriana, no clasificada en otra parte",9,5,4
2019,2 años,"Otros trastornos de los líquidos, de los electrólitos y del equilibrio ácido-básico",8,5,3
2019,2 años,Otras malformaciones congénitas del corazón,7,4,3
2019,2 años,Ahogamiento y sumersión no especificados,6,5,1
2019,2 años,Obstrucción no especificada de la respiración,5,4,1
2019,2 años,Leucemia mieloide,4,2,2
2019,2 años,"Síntomas, signos y hallazgos anormales clínicos y de laboratorio, no clasificados en otra parte",40,21,19
2019,2 años,Otras causas,145,71,74
2019,3 años,Otras gastroenteritis y colitis de origen infeccioso y no especificado,42,26,16
2019,3 años,"Neumonía, organismo no especificado",38,19,19
2019,3 años,Otras sepsis,11,3,8
2019,3 años,Exposición a factores no especificados,11,7,4
2019,3 años,Epilepsia,6,3,3
2019,3 años,Parálisis cerebral,6,3,3
2019,3 años,Íleo paralítico y obstrucción intestinal sin hernia,6,3,3
2019,3 años,Otras malformaciones congénitas del corazón,6,4,2
2019,3 años,Ahogamiento y sumersión no especificados,5,4,1
2019,3 años,"Exposición a humos, fuegos o llamas no especificados",5,4,1
2019,3 años,"Desnutrición proteicocalórica severa, no especificada",4,2,2
2019,3 años,"Accidente de vehículo de motor o sin motor, tipo de vehículo no especificado",4,1,3
2019,3 años,Tumor maligno del ojo y sus anexos,3,1,2
2019,3 años,Otras anemias aplásticas,3,1,2
2019,3 años,"Síntomas, signos y hallazgos anormales clínicos y de laboratorio, no clasificados en otra parte",31,11,20
2019,3 años,Otras causas,91,42,49
2019,4 años,"Neumonía, organismo no especificado",22,12,10
2019,4 años,Otras gastroenteritis y colitis de origen infeccioso y no especificado,20,12,8
2019,4 años,Otras sepsis,9,4,5
2019,4 años,Epilepsia,9,4,5
2019,4 años,Fiebre del dengue [dengue clásico],8,2,6
2019,4 años,Fiebre del dengue hemorrágico,7,3,4
2019,4 años,Exposición a factores no especificados,6,4,2
2019,4 años,Otros trastornos del encéfalo,5,2,3
2019,4 años,"Exposición a humos, fuegos o llamas no especificados",5,2,3
2019,4 años,Leucemia linfoide,4,2,2
2019,4 años,Otros trastornos respiratorios,4,3,1
2019,4 años,Tumor maligno del ojo y sus anexos,3,2,1
2019,4 años,Hidrocéfalo,3,1,2
2019,4 años,"Síntomas, signos y hallazgos anormales clínicos y de laboratorio, no clasificados en otra parte",21,14,7
2019,4 años,Otras causas,77,37,40
2019,5 - 9 años,"Neumonía, organismo no especificado",83,43,40
2019,5 - 9 años,Otras gastroenteritis y colitis de origen infeccioso y no especificado,59,28,31
2019,5 - 9 años,Exposición a factores no especificados,42,30,12
2019,5 - 9 años,"Accidente de vehículo de motor o sin motor, tipo de vehículo no especificado",32,18,14
2019,5 - 9 años,Fiebre del dengue [dengue clásico],21,7,14
2019,5 - 9 años,Leucemia linfoide,18,10,8
2019,5 - 9 años,Fiebre del dengue hemorrágico,16,8,8
2019,5 - 9 años,Otras sepsis,12,5,7
2019,5 - 9 años,Parálisis cerebral,12,5,7
2019,5 - 9 años,Ahogamiento y sumersión no especificados,12,9,3
2019,5 - 9 años,Obstrucción no especificada de la respiración,11,4,7
2019,5 - 9 años,Epilepsia,10,4,6
2019,5 - 9 años,Enfermedad renal crónica,10,7,3
2019,5 - 9 años,Otros trastornos del encéfalo,8,2,6
2019,5 - 9 años,Tumor maligno del encéfalo,7,4,3
2019,5 - 9 años,"Síntomas, signos y hallazgos anormales clínicos y de laboratorio, no clasificados en otra parte",56,23,33
2019,5 - 9 años,Otras causas,249,125,124
2019,10 - 14 años,"Neumonía, organismo no especificado",46,23,23
2019,10 - 14 años,"Accidente de vehículo de motor o sin motor, tipo de vehículo no especificado",45,27,18
2019,10 - 14 años,Exposición a factores no especificados,40,35,5
2019,10 - 14 años,"Agresión con disparo de otras armas de fuego, y las no especificadas",40,28,12
2019,10 - 14 años,Otras gastroenteritis y colitis de origen infeccioso y no especificado,37,22,15
2019,10 - 14 años,Leucemia linfoide,25,15,10
2019,10 - 14 años,Otros estrangulamientos y ahorcamientos accidentales,25,11,14
2019,10 - 14 años,"Lesión autoinfligida intencionalmente por ahorcamiento, estrangulamiento o sofocación",23,14,9
2019,10 - 14 años,Otras sepsis,21,12,9
2019,10 - 14 años,Epilepsia,14,11,3
2019,10 - 14 años,Enfermedad renal crónica,13,6,7
2019,10 - 14 años,Ahogamiento y sumersión no especificados,13,8,5
2019,10 - 14 años,Leucemia de células de tipo no especificado,11,8,3
2019,10 - 14 años,Complicaciones y descripciones mal definidas de enfermedad cardíaca,11,6,5
2019,10 - 14 años,Obstrucción no especificada de la respiración,11,6,5
2019,10 - 14 años,"Síntomas, signos y hallazgos anormales clínicos y de laboratorio, no clasificados en otra parte",74,39,35
2019,10 - 14 años,Otras causas,319,155,164
2019,15 - 19 años,"Agresión con disparo de otras armas de fuego, y las no especificadas",385,331,54
2019,15 - 19 años,"Accidente de vehículo de motor o sin motor, tipo de vehículo no especificado",153,125,28
2019,15 - 19 años,Exposición a factores no especificados,152,133,19
2019,15 - 19 años,"Disparo de otras armas de fuego, y las no especificadas",116,103,13
2019,15 - 19 años,"Lesión autoinfligida intencionalmente por ahorcamiento, estrangulamiento o sofocación",71,45,26
2019,15 - 19 años,"Neumonía, organismo no especificado",60,33,27
2019,15 - 19 años,Enfermedad renal crónica,55,28,27
2019,15 - 19 años,Otros estrangulamientos y ahorcamientos accidentales,48,34,14
2019,15 - 19 años,Otras gastroenteritis y colitis de origen infeccioso y no especificado,40,12,28
2019,15 - 19 años,"Agresión por ahorcamiento, estrangulamiento y sofocación",39,25,14
2019,15 - 19 años,Agresión con objeto cortante,38,21,17
2019,15 - 19 años,Ahogamiento y sumersión no especificados,37,32,5
2019,15 - 19 años,Infarto agudo del miocardio,28,15,13
2019,15 - 19 años,Epilepsia,27,18,9
2019,15 - 19 años,Agresión por medios no especificados,27,23,4
2019,15 - 19 años,"Síntomas, signos y hallazgos anormales clínicos y de laboratorio, no clasificados en otra parte",158,92,66
2019,15 - 19 años,Otras causas,714,373,341
2019,20 - 24 años,"Agresión con disparo de otras armas de fuego, y las no especificadas",511,449,62
2019,20 - 24 años,Exposición a factores no especificados,330,292,38
2019,20 - 24 años,"Accidente de vehículo de motor o sin motor, tipo de vehículo no especificado",310,279,31
2019,20 - 24 años,"Disparo de otras armas de fuego, y las no especificadas",107,94,13
2019,20 - 24 años,"Neumonía, organismo no especificado",69,42,27
2019,20 - 24 años,Enfermedad renal crónica,64,45,19
2019,20 - 24 años,"Lesión autoinfligida intencionalmente por ahorcamiento, estrangulamiento o sofocación",60,52,8
2019,20 - 24 años,Otros estrangulamientos y ahorcamientos accidentales,57,45,12
2019,20 - 24 años,Infarto agudo del miocardio,50,37,13
2019,20 - 24 años,Agresión con objeto cortante,48,40,8
2019,20 - 24 años,Agresión por medios no especificados,40,35,5
2019,20 - 24 años,Otras gastroenteritis y colitis de origen infeccioso y no especificado,29,17,12
2019,20 - 24 años,Ahogamiento y sumersión no especificados,28,25,3
2019,20 - 24 años,Insuficiencia renal no especificada,27,13,14
2019,20 - 24 años,"Síntomas, signos y hallazgos anormales clínicos y de laboratorio, no clasificados en otra parte",191,120,71
2019,20 - 24 años,Otras causas,884,526,358
2019,25 - 29 años,"Agresión con disparo de otras armas de fuego, y las no especificadas",389,347,42
2019,25 - 29 años,Exposición a factores no especificados,283,257,26
2019,25 - 29 años,"Accidente de vehículo de motor o sin motor, tipo de vehículo no especificado",233,210,23
2019,25 - 29 años,"Disparo de otras armas de fuego, y las no especificadas",84,72,12
2019,25 - 29 años,Fibrosis y cirrosis del hígado,58,50,8
2019,25 - 29 años,"Neumonía, organismo no especificado",54,23,31
2019,25 - 29 años,Enfermedad renal crónica,54,32,22
2019,25 - 29 años,Infarto agudo del miocardio,53,36,17
2019,25 - 29 años,"Envenenamiento accidental por, y exposición al alcohol",49,44,5
2019,25 - 29 años,Otras gastroenteritis y colitis de origen infeccioso y no especificado,48,33,15
2019,25 - 29 años,Otros estrangulamientos y ahorcamientos accidentales,45,35,10
2019,25 - 29 años,Agresión con objeto cortante,44,38,6
2019,25 - 29 años,"Lesión autoinfligida intencionalmente por ahorcamiento, estrangulamiento o sofocación",39,35,4
2019,25 - 29 años,Enfermedad alcohólica del hígado,38,34,4
2019,25 - 29 años,"Diabetes mellitus, no especificada",36,21,15
2019,25 - 29 años,"Síntomas, signos y hallazgos anormales clínicos y de laboratorio, no clasificados en otra parte",203,126,77
2019,25 - 29 años,Otras causas,981,589,392
2019,30 - 34 años,"Agresión con disparo de otras armas de fuego, y las no especificadas",313,274,39
2019,30 - 34 años,Exposición a factores no especificados,232,206,26
2019,30 - 34 años,"Accidente de vehículo de motor o sin motor, tipo de vehículo no especificado",196,165,31
2019,30 - 34 años,Fibrosis y cirrosis del hígado,114,90,24
2019,30 - 34 años,"Neumonía, organismo no especificado",77,45,32
2019,30 - 34 años,Infarto agudo del miocardio,64,43,21
2019,30 - 34 años,"Diabetes mellitus, no especificada",61,25,36
2019,30 - 34 años,"Envenenamiento accidental por, y exposición al alcohol",60,53,7
2019,30 - 34 años,Enfermedad renal crónica,59,33,26
2019,30 - 34 años,Enfermedad alcohólica del hígado,56,48,8
2019,30 - 34 años,"Disparo de otras armas de fuego, y las no especificadas",56,49,7
2019,30 - 34 años,Otras gastroenteritis y colitis de origen infeccioso y no especificado,41,30,11
2019,30 - 34 años,Trastornos mentales y del comportamiento debidos al uso de alcohol,38,36,2
2019,30 - 34 años,Agresión con objeto cortante,35,28,7
2019,30 - 34 años,Pancreatitis aguda,32,27,5
2019,30 - 34 años,"Síntomas, signos y hallazgos anormales clínicos y de laboratorio, no clasificados en otra parte",215,137,78
2019,30 - 34 años,Otras causas,1072,608,464
2019,35 - 39 años,"Agresión con disparo de otras armas de fuego, y las no especificadas",269,238,31
2019,35 - 39 años,Exposición a factores no especificados,186,160,26
2019,35 - 39 años,Fibrosis y cirrosis del hígado,150,124,26
2019,35 - 39 años,"Accidente de vehículo de motor o sin motor, tipo de vehículo no especificado",146,120,26
2019,35 - 39 años,"Diabetes mellitus, no especificada",107,57,50
2019,35 - 39 años,"Neumonía, organismo no especificado",105,62,43
2019,35 - 39 años,Infarto agudo del miocardio,85,57,28
2019,35 - 39 años,Enfermedad alcohólica del hígado,78,72,6
2019,35 - 39 años,Enfermedad renal crónica,65,37,28
2019,35 - 39 años,"Envenenamiento accidental por, y exposición al alcohol",65,59,6
2019,35 - 39 años,Trastornos mentales y del comportamiento debidos al uso de alcohol,64,56,8
2019,35 - 39 años,"Disparo de otras armas de fuego, y las no especificadas",53,42,11
2019,35 - 39 años,Otras sepsis,41,20,21
2019,35 - 39 años,Tumor maligno del estómago,39,17,22
2019,35 - 39 años,Otras gastroenteritis y colitis de origen infeccioso y no especificado,38,22,16
2019,35 - 39 años,"Síntomas, signos y hallazgos anormales clínicos y de laboratorio, no clasificados en otra parte",254,166,88
2019,35 - 39 años,Otras causas,1231,677,554
2019,40 - 44 años,"Agresión con disparo de otras armas de fuego, y las no especificadas",217,183,34
2019,40 - 44 años,Fibrosis y cirrosis del hígado,210,165,45
2019,40 - 44 años,"Diabetes mellitus, no especificada",200,102,98
2019,40 - 44 años,Exposición a factores no especificados,173,157,16
2019,40 - 44 años,Infarto agudo del miocardio,139,82,57
2019,40 - 44 años,"Neumonía, organismo no especificado",110,62,48
2019,40 - 44 años,"Accidente de vehículo de motor o sin motor, tipo de vehículo no especificado",107,84,23
2019,40 - 44 años,"Envenenamiento accidental por, y exposición al alcohol",90,83,7
2019,40 - 44 años,Enfermedad renal crónica,87,46,41
2019,40 - 44 años,Enfermedad alcohólica del hígado,81,69,12
2019,40 - 44 años,Diabetes mellitus no insulinodependiente,64,30,34
2019,40 - 44 años,Trastornos mentales y del comportamiento debidos al uso de alcohol,53,47,6
2019,40 - 44 años,Otras gastroenteritis y colitis de origen infeccioso y no especificado,50,21,29
2019,40 - 44 años,Insuficiencia renal no especificada,45,22,23
2019,40 - 44 años,"Disparo de otras armas de fuego, y las no especificadas",44,36,8
2019,40 - 44 años,"Síntomas, signos y hallazgos anormales clínicos y de laboratorio, no clasificados en otra parte",320,190,130
2019,40 - 44 años,Otras causas,1275,676,599
2019,45 - 49 años,"Diabetes mellitus, no especificada",289,121,168
2019,45 - 49 años,Fibrosis y cirrosis del hígado,247,182,65
2019,45 - 49 años,Infarto agudo del miocardio,152,80,72
2019,45 - 49 años,Exposición a factores no especificados,151,132,19
2019,45 - 49 años,"Neumonía, organismo no especificado",132,80,52
2019,45 - 49 años,"Agresión con disparo de otras armas de fuego, y las no especificadas",120,101,19
2019,45 - 49 años,Enfermedad renal crónica,107,61,46
2019,45 - 49 años,Enfermedad alcohólica del hígado,95,85,10
2019,45 - 49 años,Diabetes mellitus no insulinodependiente,85,37,48
2019,45 - 49 años,"Accidente de vehículo de motor o sin motor, tipo de vehículo no especificado",83,73,10
2019,45 - 49 años,"Envenenamiento accidental por, y exposición al alcohol",80,76,4
2019,45 - 49 años,Trastornos mentales y del comportamiento debidos al uso de alcohol,67,57,10
2019,45 - 49 años,Tumor maligno del estómago,66,32,34
2019,45 - 49 años,Insuficiencia renal no especificada,65,38,27
2019,45 - 49 años,Tumor maligno del hígado y de las vías biliares intrahepáticas,60,32,28
2019,45 - 49 años,"Síntomas, signos y hallazgos anormales clínicos y de laboratorio, no clasificados en otra parte",314,185,129
2019,45 - 49 años,Otras causas,1341,717,624
2019,50 - 54 años,"Diabetes mellitus, no especificada",406,156,250
2019,50 - 54 años,Fibrosis y cirrosis del hígado,262,183,79
2019,50 - 54 años,Infarto agudo del miocardio,246,150,96
2019,50 - 54 años,Exposición a factores no especificados,150,133,17
2019,50 - 54 años,"Neumonía, organismo no especificado",140,86,54
2019,50 - 54 años,Diabetes mellitus no insulinodependiente,111,45,66
2019,50 - 54 años,Enfermedad renal crónica,106,57,49
2019,50 - 54 años,Enfermedad alcohólica del hígado,89,79,10
2019,50 - 54 años,Tumor maligno del hígado y de las vías biliares intrahepáticas,80,30,50
2019,50 - 54 años,"Accidente de vehículo de motor o sin motor, tipo de vehículo no especificado",77,69,8
2019,50 - 54 años,"Envenenamiento accidental por, y exposición al alcohol",76,68,8
2019,50 - 54 años,"Agresión con disparo de otras armas de fuego, y las no especificadas",73,66,7
2019,50 - 54 años,Insuficiencia renal no especificada,72,38,34
2019,50 - 54 años,Tumor maligno del estómago,66,25,41
2019,50 - 54 años,Otras gastroenteritis y colitis de origen infeccioso y no especificado,57,28,29
2019,50 - 54 años,"Síntomas, signos y hallazgos anormales clínicos y de laboratorio, no clasificados en otra parte",437,256,181
2019,50 - 54 años,Otras causas,1428,712,716
2019,55 - 59 años,"Diabetes mellitus, no especificada",582,236,346
2019,55 - 59 años,Fibrosis y cirrosis del hígado,336,203,133
2019,55 - 59 años,Infarto agudo del miocardio,292,168,124
2019,55 - 59 años,Diabetes mellitus no insulinodependiente,211,94,117
2019,55 - 59 años,"Neumonía, organismo no especificado",195,101,94
2019,55 - 59 años,Enfermedad renal crónica,175,90,85
2019,55 - 59 años,Exposición a factores no especificados,144,123,21
2019,55 - 59 años,Tumor maligno del hígado y de las vías biliares intrahepáticas,131,59,72
2019,55 - 59 años,Insuficiencia renal no especificada,96,54,42
2019,55 - 59 años,Tumor maligno del estómago,88,40,48
2019,55 - 59 años,Otras sepsis,73,29,44
2019,55 - 59 años,Enfermedad alcohólica del hígado,69,57,12
2019,55 - 59 años,"Accidente de vehículo de motor o sin motor, tipo de vehículo no especificado",68,56,12
2019,55 - 59 años,Insuficiencia cardíaca,64,27,37
2019,55 - 59 años,Otras gastroenteritis y colitis de origen infeccioso y no especificado,63,24,39
2019,55 - 59 años,"Síntomas, signos y hallazgos anormales clínicos y de laboratorio, no clasificados en otra parte",534,278,256
2019,55 - 59 años,Otras causas,1785,924,861
2019,60 - 64 años,"Diabetes mellitus, no especificada",642,255,387
2019,60 - 64 años,Infarto agudo del miocardio,412,236,176
2019,60 - 64 años,Fibrosis y cirrosis del hígado,334,199,135
2019,60 - 64 años,"Neumonía, organismo no especificado",272,131,141
2019,60 - 64 años,Diabetes mellitus no insulinodependiente,223,90,133
2019,60 - 64 años,Tumor maligno del hígado y de las vías biliares intrahepáticas,192,86,106
2019,60 - 64 años,Enfermedad renal crónica,183,94,89
2019,60 - 64 años,Tumor maligno del estómago,124,55,69
2019,60 - 64 años,Exposición a factores no especificados,112,91,21
2019,60 - 64 años,Insuficiencia renal no especificada,100,55,45
2019,60 - 64 años,"Accidente vascular encefálico agudo, no especificado como hemorrágico o isquémico",95,45,50
2019,60 - 64 años,Otras gastroenteritis y colitis de origen infeccioso y no especificado,83,42,41
2019,60 - 64 años,Insuficiencia cardíaca,81,41,40
2019,60 - 64 años,Otras enfermedades cerebrovasculares,67,29,38
2019,60 - 64 años,Otras sepsis,63,31,32
2019,60 - 64 años,"Síntomas, signos y hallazgos anormales clínicos y de laboratorio, no clasificados en otra parte",614,329,285
2019,60 - 64 años,Otras causas,1983,1032,951
2019,65 - 69 años,"Diabetes mellitus, no especificada",689,270,419
2019,65 - 69 años,Infarto agudo del miocardio,532,307,225
2019,65 - 69 años,"Neumonía, organismo no especificado",348,172,176
2019,65 - 69 años,Fibrosis y cirrosis del hígado,348,195,153
2019,65 - 69 años,Diabetes mellitus no insulinodependiente,248,101,147
2019,65 - 69 años,Tumor maligno del hígado y de las vías biliares intrahepáticas,241,111,130
2019,65 - 69 años,Enfermedad renal crónica,239,122,117
2019,65 - 69 años,Tumor maligno del estómago,150,74,76
2019,65 - 69 años,"Accidente vascular encefálico agudo, no especificado como hemorrágico o isquémico",129,67,62
2019,65 - 69 años,Insuficiencia renal no especificada,113,66,47
2019,65 - 69 años,Exposición a factores no especificados,111,84,27
2019,65 - 69 años,Otras gastroenteritis y colitis de origen infeccioso y no especificado,106,44,62
2019,65 - 69 años,Insuficiencia cardíaca,104,46,58
2019,65 - 69 años,Otras enfermedades cerebrovasculares,81,54,27
2019,65 - 69 años,Otras sepsis,62,33,29
2019,65 - 69 años,"Síntomas, signos y hallazgos anormales clínicos y de laboratorio, no clasificados en otra parte",781,375,406
2019,65 - 69 años,Otras causas,2067,1107,960
2019,70 - 74 años,Infarto agudo del miocardio,609,346,263
2019,70 - 74 años,"Diabetes mellitus, no especificada",599,222,377
2019,70 - 74 años,"Neumonía, organismo no especificado",474,242,232
2019,70 - 74 años,Fibrosis y cirrosis del hígado,255,129,126
2019,70 - 74 años,Tumor maligno del hígado y de las vías biliares intrahepáticas,245,123,122
2019,70 - 74 años,Diabetes mellitus no insulinodependiente,222,96,126
2019,70 - 74 años,Enfermedad renal crónica,189,98,91
2019,70 - 74 años,"Accidente vascular encefálico agudo, no especificado como hemorrágico o isquémico",163,75,88
2019,70 - 74 años,Tumor maligno del estómago,143,73,70
2019,70 - 74 años,Insuficiencia cardíaca,128,60,68
2019,70 - 74 años,Exposición a factores no especificados,124,90,34
2019,70 - 74 años,Otras gastroenteritis y colitis de origen infeccioso y no especificado,119,58,61
2019,70 - 74 años,Insuficiencia renal no especificada,112,56,56
2019,70 - 74 años,Otras enfermedades pulmonares obstructivas crónicas,96,49,47
2019,70 - 74 años,Otras sepsis,85,43,42
2019,70 - 74 años,"Síntomas, signos y hallazgos anormales clínicos y de laboratorio, no clasificados en otra parte",951,457,494
2019,70 - 74 años,Otras causas,2244,1201,1043
2019,75 - 79 años,Infarto agudo del miocardio,665,358,307
2019,75 - 79 años,"Neumonía, organismo no especificado",578,289,289
2019,75 - 79 años,"Diabetes mellitus, no especificada",518,202,316
2019,75 - 79 años,"Accidente vascular encefálico agudo, no especificado como hemorrágico o isquémico",242,125,117
2019,75 - 79 años,Diabetes mellitus no insulinodependiente,212,75,137
2019,75 - 79 años,Tumor maligno del hígado y de las vías biliares intrahepáticas,203,93,110
2019,75 - 79 años,Insuficiencia cardíaca,170,71,99
2019,75 - 79 años,Enfermedad renal crónica,157,85,72
2019,75 - 79 años,Fibrosis y cirrosis del hígado,151,78,73
2019,75 - 79 años,Otras gastroenteritis y colitis de origen infeccioso y no especificado,133,60,73
2019,75 - 79 años,Tumor maligno del estómago,130,60,70
2019,75 - 79 años,Exposición a factores no especificados,112,76,36
2019,75 - 79 años,Otras enfermedades pulmonares obstructivas crónicas,106,55,51
2019,75 - 79 años,Insuficiencia renal no especificada,105,51,54
2019,75 - 79 años,"Síntomas, signos y hallazgos anormales clínicos y de laboratorio, no clasificados en otra parte",1079,549,530
2019,75 - 79 años,Otras causas,2228,1177,1051
2019,80 - 84 años,Infarto agudo del miocardio,806,407,399
2019,80 - 84 años,"Neumonía, organismo no especificado",761,367,394
2019,80 - 84 años,"Diabetes mellitus, no especificada",401,160,241
2019,80 - 84 años,"Accidente vascular encefálico agudo, no especificado como hemorrágico o isquémico",265,142,123
2019,80 - 84 años,Insuficiencia cardíaca,208,115,93
2019,80 - 84 años,Otras gastroenteritis y colitis de origen infeccioso y no especificado,148,73,75
2019,80 - 84 años,Diabetes mellitus no insulinodependiente,147,61,86
2019,80 - 84 años,Tumor maligno del hígado y de las vías biliares intrahepáticas,145,73,72
2019,80 - 84 años,Otras enfermedades pulmonares obstructivas crónicas,143,77,66
2019,80 - 84 años,Hipertensión esencial (primaria),136,64,72
2019,80 - 84 años,Otras enfermedades cerebrovasculares,136,60,76
2019,80 - 84 años,Fibrosis y cirrosis del hígado,132,64,68
2019,80 - 84 años,Tumor maligno del estómago,121,57,64
2019,80 - 84 años,Enfermedad renal crónica,117,62,55
2019,80 - 84 años,"Síntomas, signos y hallazgos anormales clínicos y de laboratorio, no clasificados en otra parte",1375,670,705
2019,80 - 84 años,Otras causas,2161,1039,1122
2019,85 y más,Infarto agudo del miocardio,1759,835,924
2019,85 y más,"Neumonía, organismo no especificado",1518,740,778
2019,85 y más,Insuficiencia cardíaca,531,234,297
2019,85 y más,"Accidente vascular encefálico agudo, no especificado como hemorrágico o isquémico",437,178,259
2019,85 y más,"Diabetes mellitus, no especificada",410,158,252
2019,85 y más,Hipertensión esencial (primaria),293,124,169
2019,85 y más,Otras enfermedades pulmonares obstructivas crónicas,285,140,145
2019,85 y más,Otras enfermedades cerebrovasculares,229,106,123
2019,85 y más,"Desnutrición proteicocalórica, no especificada",227,96,131
2019,85 y más,Otras gastroenteritis y colitis de origen infeccioso y no especificado,216,112,104
2019,85 y más,Diabetes mellitus no insulinodependiente,186,65,121
2019,85 y más,Exposición a factores no especificados,148,79,69
2019,85 y más,Enfermedad renal crónica,138,81,57
2019,85 y más,Insuficiencia renal no especificada,130,64,66
2019,85 y más,"Síntomas, signos y hallazgos anormales clínicos y de laboratorio, no clasificados en otra parte",289,1293,1597
2019,85 y más,Otras causas,2947,133,1617
